sample_id,strain1,strain2,chrom,start,end,length
SMI000-K02-B01-M02,0,1,Pf3D7_01_v3,92914,575569,482655
SMI000-K02-B01-M02,0,1,Pf3D7_02_v3,106095,665889,559794
SMI000-K02-B01-M02,0,1,Pf3D7_02_v3,670525,862487,191962
SMI000-K02-B01-M02,0,1,Pf3D7_03_v3,70645,758257,687612
SMI000-K02-B01-M02,0,1,Pf3D7_04_v3,169097,1143943,974846
SMI000-K02-B01-M02,0,1,Pf3D7_05_v3,38009,1039294,1001285
SMI000-K02-B01-M02,0,1,Pf3D7_06_v3,91536,1091783,1000247
SMI000-K02-B01-M02,0,1,Pf3D7_07_v3,259248,969340,710092
SMI000-K02-B01-M02,0,1,Pf3D7_08_v3,308376,317139,8763
SMI000-K02-B01-M02,0,1,Pf3D7_08_v3,332201,1364861,1032660
SMI000-K02-B01-M02,0,1,Pf3D7_09_v3,79899,702555,622656
SMI000-K02-B01-M02,0,1,Pf3D7_09_v3,1112490,1473498,361008
SMI000-K02-B01-M02,0,1,Pf3D7_10_v3,69349,382089,312740
SMI000-K02-B01-M02,0,1,Pf3D7_10_v3,1401373,1571493,170120
SMI000-K02-B01-M02,0,1,Pf3D7_11_v3,110021,504801,394780
SMI000-K02-B01-M02,0,1,Pf3D7_11_v3,1051906,1167285,115379
SMI000-K02-B01-M02,0,1,Pf3D7_11_v3,1346691,1374796,28105
SMI000-K02-B01-M02,0,1,Pf3D7_12_v3,440296,2084872,1644576
SMI000-K02-B01-M02,0,1,Pf3D7_12_v3,2138818,2163685,24867
SMI000-K02-B01-M02,0,1,Pf3D7_13_v3,74436,173722,99286
SMI000-K02-B01-M02,0,1,Pf3D7_13_v3,298500,584127,285627
SMI000-K02-B01-M02,0,1,Pf3D7_13_v3,793453,1812581,1019128
SMI000-K02-B01-M02,0,1,Pf3D7_13_v3,2078718,2634027,555309
SMI000-K02-B01-M02,0,1,Pf3D7_13_v3,2648084,2791755,143671
SMI000-K02-B01-M02,0,1,Pf3D7_14_v3,35796,315781,279985
SMI000-K02-B01-M02,0,1,Pf3D7_14_v3,1111084,1556728,445644
SMI000-K02-B01-M02,0,1,Pf3D7_14_v3,1683808,1686120,2312
SMI000-K02-B01-M02,0,1,Pf3D7_14_v3,2110452,2179970,69518
SMI000-K02-B01-M02,0,1,Pf3D7_14_v3,2265115,2352910,87795
SMI000-K02-B01-M02,0,1,Pf3D7_14_v3,2861742,3255707,393965
SMI001-K02-B01-M02,0,1,Pf3D7_01_v3,92914,575569,482655
SMI001-K02-B01-M02,0,1,Pf3D7_02_v3,106095,862487,756392
SMI001-K02-B01-M02,0,1,Pf3D7_03_v3,70645,756760,686115
SMI001-K02-B01-M02,0,1,Pf3D7_04_v3,155749,1141686,985937
SMI001-K02-B01-M02,0,1,Pf3D7_05_v3,351908,500753,148845
SMI001-K02-B01-M02,0,1,Pf3D7_05_v3,614257,1252815,638558
SMI001-K02-B01-M02,0,1,Pf3D7_06_v3,147133,930617,783484
SMI001-K02-B01-M02,0,1,Pf3D7_06_v3,1230005,1294804,64799
SMI001-K02-B01-M02,0,1,Pf3D7_07_v3,77107,243608,166501
SMI001-K02-B01-M02,0,1,Pf3D7_07_v3,328470,615996,287526
SMI001-K02-B01-M02,0,1,Pf3D7_07_v3,893290,992208,98918
SMI001-K02-B01-M02,0,1,Pf3D7_08_v3,166674,1129648,962974
SMI001-K02-B01-M02,0,1,Pf3D7_08_v3,1282537,1364861,82324
SMI001-K02-B01-M02,0,1,Pf3D7_09_v3,79899,329251,249352
SMI001-K02-B01-M02,0,1,Pf3D7_09_v3,863928,1348043,484115
SMI001-K02-B01-M02,0,1,Pf3D7_09_v3,1397999,1473498,75499
SMI001-K02-B01-M02,0,1,Pf3D7_10_v3,69349,120847,51498
SMI001-K02-B01-M02,0,1,Pf3D7_10_v3,305179,334745,29566
SMI001-K02-B01-M02,0,1,Pf3D7_10_v3,396587,1571493,1174906
SMI001-K02-B01-M02,0,1,Pf3D7_11_v3,110021,1151047,1041026
SMI001-K02-B01-M02,0,1,Pf3D7_11_v3,1207885,1374796,166911
SMI001-K02-B01-M02,0,1,Pf3D7_11_v3,1748883,2003304,254421
SMI001-K02-B01-M02,0,1,Pf3D7_12_v3,60438,1104642,1044204
SMI001-K02-B01-M02,0,1,Pf3D7_12_v3,1427424,1561003,133579
SMI001-K02-B01-M02,0,1,Pf3D7_12_v3,1688272,2163685,475413
SMI001-K02-B01-M02,0,1,Pf3D7_13_v3,74436,756148,681712
SMI001-K02-B01-M02,0,1,Pf3D7_13_v3,793453,1870818,1077365
SMI001-K02-B01-M02,0,1,Pf3D7_13_v3,1916591,2648084,731493
SMI001-K02-B01-M02,0,1,Pf3D7_14_v3,444734,1392801,948067
SMI001-K02-B01-M02,0,1,Pf3D7_14_v3,1556728,1592318,35590
SMI001-K02-B01-M02,0,1,Pf3D7_14_v3,1627410,2383558,756148
SMI001-K02-B01-M02,0,1,Pf3D7_14_v3,2394407,2822263,427856
SMI001-K02-B01-M02,0,1,Pf3D7_14_v3,2835807,2927615,91808
SMI002-K02-B01-M01,0,1,Pf3D7_04_v3,212624,259190,46566
SMI002-K02-B01-M01,0,1,Pf3D7_05_v3,1207477,1252815,45338
SMI002-K02-B01-M01,0,1,Pf3D7_06_v3,820159,930617,110458
SMI002-K02-B01-M01,0,1,Pf3D7_06_v3,985551,1043030,57479
SMI002-K02-B01-M01,0,1,Pf3D7_07_v3,1007699,1381532,373833
SMI002-K02-B01-M01,0,1,Pf3D7_08_v3,73645,1364861,1291216
SMI002-K02-B01-M01,0,1,Pf3D7_09_v3,79899,863928,784029
SMI002-K02-B01-M01,0,1,Pf3D7_10_v3,606909,868592,261683
SMI002-K02-B01-M01,0,1,Pf3D7_12_v3,1561003,1597131,36128
SMI002-K02-B01-M01,0,1,Pf3D7_13_v3,327827,394594,66767
SMI002-K02-B01-M01,0,1,Pf3D7_13_v3,2648084,2791755,143671
SMI002-K02-B01-M01,0,1,Pf3D7_14_v3,35796,246899,211103
SMI002-K02-B01-M01,0,1,Pf3D7_14_v3,1033182,1352644,319462
SMI002-K02-B01-M01,0,1,Pf3D7_14_v3,1723267,1727048,3781
SMI002-K02-B01-M01,0,1,Pf3D7_14_v3,2812213,3049131,236918
SMI004-K02-B01-M01,0,1,Pf3D7_01_v3,112353,314280,201927
SMI004-K02-B01-M01,0,1,Pf3D7_01_v3,318916,575569,256653
SMI004-K02-B01-M01,0,1,Pf3D7_02_v3,106095,231341,125246
SMI004-K02-B01-M01,0,1,Pf3D7_02_v3,308325,487179,178854
SMI004-K02-B01-M01,0,1,Pf3D7_02_v3,675595,862487,186892
SMI004-K02-B01-M01,0,1,Pf3D7_03_v3,70645,561928,491283
SMI004-K02-B01-M01,0,1,Pf3D7_04_v3,1100716,1143943,43227
SMI004-K02-B01-M01,0,1,Pf3D7_05_v3,38009,1089116,1051107
SMI004-K02-B01-M01,0,1,Pf3D7_06_v3,359320,1294804,935484
SMI004-K02-B01-M01,0,1,Pf3D7_07_v3,77107,137903,60796
SMI004-K02-B01-M01,0,1,Pf3D7_09_v3,1053693,1473498,419805
SMI004-K02-B01-M01,0,1,Pf3D7_10_v3,69349,606909,537560
SMI004-K02-B01-M01,0,1,Pf3D7_11_v3,473069,709015,235946
SMI004-K02-B01-M01,0,1,Pf3D7_13_v3,127536,327842,200306
SMI004-K02-B01-M01,0,1,Pf3D7_13_v3,2134052,2213524,79472
SMI004-K02-B01-M01,0,1,Pf3D7_14_v3,1343651,1518996,175345
SMI004-K02-B01-M01,0,1,Pf3D7_14_v3,1723267,1898822,175555
SMI004-K02-B01-M01,0,1,Pf3D7_14_v3,3038567,3209346,170779
SMI008-K02-B01-M02,0,1,Pf3D7_01_v3,92914,567178,474264
SMI008-K02-B01-M02,0,1,Pf3D7_02_v3,588001,862487,274486
SMI008-K02-B01-M02,0,1,Pf3D7_03_v3,70645,1002873,932228
SMI008-K02-B01-M02,0,1,Pf3D7_04_v3,91421,1143943,1052522
SMI008-K02-B01-M02,0,1,Pf3D7_05_v3,38009,1321344,1283335
SMI008-K02-B01-M02,0,1,Pf3D7_06_v3,72403,592617,520214
SMI008-K02-B01-M02,0,1,Pf3D7_06_v3,930617,1294804,364187
SMI008-K02-B01-M02,0,1,Pf3D7_07_v3,77107,957950,880843
SMI008-K02-B01-M02,0,1,Pf3D7_09_v3,738059,1473498,735439
SMI008-K02-B01-M02,0,1,Pf3D7_10_v3,69349,606909,537560
SMI008-K02-B01-M02,0,1,Pf3D7_10_v3,1440348,1571493,131145
SMI008-K02-B01-M02,0,1,Pf3D7_11_v3,110021,1439650,1329629
SMI008-K02-B01-M02,0,1,Pf3D7_12_v3,1120881,2138676,1017795
SMI008-K02-B01-M02,0,1,Pf3D7_12_v3,2141117,2163685,22568
SMI008-K02-B01-M02,0,1,Pf3D7_13_v3,74436,316494,242058
SMI008-K02-B01-M02,0,1,Pf3D7_13_v3,353256,514389,161133
SMI008-K02-B01-M02,0,1,Pf3D7_13_v3,553561,1865228,1311667
SMI008-K02-B01-M02,0,1,Pf3D7_13_v3,2091204,2753464,662260
SMI008-K02-B01-M02,0,1,Pf3D7_14_v3,190288,291203,100915
SMI008-K02-B01-M02,0,1,Pf3D7_14_v3,1033182,1723267,690085
SMI008-K02-B01-M02,0,1,Pf3D7_14_v3,1732738,2188890,456152
SMI008-K02-B01-M02,0,1,Pf3D7_14_v3,2845936,3255707,409771
SMI000-K03-B02-M02,0,1,Pf3D7_01_v3,92914,575569,482655
SMI000-K03-B02-M02,0,1,Pf3D7_02_v3,106095,665889,559794
SMI000-K03-B02-M02,0,1,Pf3D7_04_v3,808208,1100716,292508
SMI000-K03-B02-M02,0,1,Pf3D7_05_v3,104711,1321344,1216633
SMI000-K03-B02-M02,0,1,Pf3D7_06_v3,72403,478476,406073
SMI000-K03-B02-M02,0,1,Pf3D7_06_v3,930617,1294804,364187
SMI000-K03-B02-M02,0,1,Pf3D7_07_v3,77107,893290,816183
SMI000-K03-B02-M02,0,1,Pf3D7_07_v3,908813,915020,6207
SMI000-K03-B02-M02,0,1,Pf3D7_07_v3,1038581,1381532,342951
SMI000-K03-B02-M02,0,1,Pf3D7_08_v3,73645,317139,243494
SMI000-K03-B02-M02,0,1,Pf3D7_08_v3,627408,1131245,503837
SMI000-K03-B02-M02,0,1,Pf3D7_08_v3,1222615,1364861,142246
SMI000-K03-B02-M02,0,1,Pf3D7_09_v3,79899,100618,20719
SMI000-K03-B02-M02,0,1,Pf3D7_09_v3,863928,1473498,609570
SMI000-K03-B02-M02,0,1,Pf3D7_10_v3,69349,1571493,1502144
SMI000-K03-B02-M02,0,1,Pf3D7_11_v3,110021,1488242,1378221
SMI000-K03-B02-M02,0,1,Pf3D7_11_v3,1640505,1683080,42575
SMI000-K03-B02-M02,0,1,Pf3D7_12_v3,238046,261090,23044
SMI000-K03-B02-M02,0,1,Pf3D7_12_v3,398677,1561003,1162326
SMI000-K03-B02-M02,0,1,Pf3D7_12_v3,1594625,2163685,569060
SMI000-K03-B02-M02,0,1,Pf3D7_13_v3,74436,394156,319720
SMI000-K03-B02-M02,0,1,Pf3D7_13_v3,793453,2648084,1854631
SMI000-K03-B02-M02,0,1,Pf3D7_14_v3,361273,912071,550798
SMI000-K03-B02-M02,0,1,Pf3D7_14_v3,1238918,1614592,375674
SMI000-K03-B02-M02,0,1,Pf3D7_14_v3,1635508,2083563,448055
SMI000-K03-B02-M02,0,1,Pf3D7_14_v3,2507884,2808922,301038
SMI004-K03-B01-M02,0,1,Pf3D7_01_v3,92914,575569,482655
SMI004-K03-B01-M02,0,1,Pf3D7_02_v3,106095,862487,756392
SMI004-K03-B01-M02,0,1,Pf3D7_03_v3,70645,179026,108381
SMI004-K03-B01-M02,0,1,Pf3D7_05_v3,412164,811370,399206
SMI004-K03-B01-M02,0,1,Pf3D7_06_v3,402842,1294804,891962
SMI004-K03-B01-M02,0,1,Pf3D7_07_v3,77107,1012220,935113
SMI004-K03-B01-M02,0,1,Pf3D7_08_v3,109267,904131,794864
SMI004-K03-B01-M02,0,1,Pf3D7_08_v3,906873,1364861,457988
SMI004-K03-B01-M02,0,1,Pf3D7_09_v3,79899,1100553,1020654
SMI004-K03-B01-M02,0,1,Pf3D7_09_v3,1170124,1473498,303374
SMI004-K03-B01-M02,0,1,Pf3D7_10_v3,69349,312665,243316
SMI004-K03-B01-M02,0,1,Pf3D7_10_v3,1227765,1571493,343728
SMI004-K03-B01-M02,0,1,Pf3D7_11_v3,110021,2003304,1893283
SMI004-K03-B01-M02,0,1,Pf3D7_12_v3,60438,576039,515601
SMI004-K03-B01-M02,0,1,Pf3D7_12_v3,646451,892951,246500
SMI004-K03-B01-M02,0,1,Pf3D7_12_v3,1367715,1588376,220661
SMI004-K03-B01-M02,0,1,Pf3D7_12_v3,1778367,1861003,82636
SMI004-K03-B01-M02,0,1,Pf3D7_12_v3,1924730,2149050,224320
SMI004-K03-B01-M02,0,1,Pf3D7_13_v3,199544,793453,593909
SMI004-K03-B01-M02,0,1,Pf3D7_13_v3,947215,1285474,338259
SMI004-K03-B01-M02,0,1,Pf3D7_13_v3,1382718,1511677,128959
SMI004-K03-B01-M02,0,1,Pf3D7_13_v3,1840029,2640333,800304
SMI004-K03-B01-M02,0,1,Pf3D7_13_v3,2648084,2791755,143671
SMI004-K03-B01-M02,0,1,Pf3D7_14_v3,35796,135456,99660
SMI004-K03-B01-M02,0,1,Pf3D7_14_v3,1393166,1556728,163562
SMI004-K03-B01-M02,0,1,Pf3D7_14_v3,1723267,1733124,9857
SMI004-K03-B01-M02,0,1,Pf3D7_14_v3,2154014,2968044,814030
SMI004-K03-B01-M02,0,2,Pf3D7_01_v3,92914,575569,482655
SMI004-K03-B01-M02,0,2,Pf3D7_02_v3,106095,862487,756392
SMI004-K03-B01-M02,0,2,Pf3D7_03_v3,70645,350059,279414
SMI004-K03-B01-M02,0,2,Pf3D7_03_v3,546089,563286,17197
SMI004-K03-B01-M02,0,2,Pf3D7_04_v3,1100716,1143943,43227
SMI004-K03-B01-M02,0,2,Pf3D7_05_v3,38009,201873,163864
SMI004-K03-B01-M02,0,2,Pf3D7_05_v3,412164,1252815,840651
SMI004-K03-B01-M02,0,2,Pf3D7_06_v3,402842,801914,399072
SMI004-K03-B01-M02,0,2,Pf3D7_06_v3,859389,1294804,435415
SMI004-K03-B01-M02,0,2,Pf3D7_07_v3,77107,1012220,935113
SMI004-K03-B01-M02,0,2,Pf3D7_08_v3,109267,904131,794864
SMI004-K03-B01-M02,0,2,Pf3D7_08_v3,906873,1364861,457988
SMI004-K03-B01-M02,0,2,Pf3D7_09_v3,79899,863928,784029
SMI004-K03-B01-M02,0,2,Pf3D7_09_v3,1170124,1473498,303374
SMI004-K03-B01-M02,0,2,Pf3D7_10_v3,69349,312665,243316
SMI004-K03-B01-M02,0,2,Pf3D7_11_v3,493315,921603,428288
SMI004-K03-B01-M02,0,2,Pf3D7_12_v3,181119,2149050,1967931
SMI004-K03-B01-M02,0,2,Pf3D7_13_v3,199544,947215,747671
SMI004-K03-B01-M02,0,2,Pf3D7_13_v3,1285474,1382718,97244
SMI004-K03-B01-M02,0,2,Pf3D7_13_v3,1840029,2791755,951726
SMI004-K03-B01-M02,0,2,Pf3D7_14_v3,35796,746994,711198
SMI004-K03-B01-M02,0,2,Pf3D7_14_v3,1033182,1733124,699942
SMI004-K03-B01-M02,0,2,Pf3D7_14_v3,2154014,3216241,1062227
SMI004-K03-B01-M02,1,2,Pf3D7_01_v3,92914,575569,482655
SMI004-K03-B01-M02,1,2,Pf3D7_02_v3,106095,862487,756392
SMI004-K03-B01-M02,1,2,Pf3D7_03_v3,70645,179026,108381
SMI004-K03-B01-M02,1,2,Pf3D7_03_v3,350059,546089,196030
SMI004-K03-B01-M02,1,2,Pf3D7_03_v3,563286,1002873,439587
SMI004-K03-B01-M02,1,2,Pf3D7_04_v3,91421,1100716,1009295
SMI004-K03-B01-M02,1,2,Pf3D7_05_v3,201873,811370,609497
SMI004-K03-B01-M02,1,2,Pf3D7_05_v3,1252815,1321344,68529
SMI004-K03-B01-M02,1,2,Pf3D7_06_v3,72403,801914,729511
SMI004-K03-B01-M02,1,2,Pf3D7_06_v3,859389,1294804,435415
SMI004-K03-B01-M02,1,2,Pf3D7_07_v3,77107,1381532,1304425
SMI004-K03-B01-M02,1,2,Pf3D7_08_v3,73645,1364861,1291216
SMI004-K03-B01-M02,1,2,Pf3D7_09_v3,79899,863928,784029
SMI004-K03-B01-M02,1,2,Pf3D7_09_v3,1100553,1473498,372945
SMI004-K03-B01-M02,1,2,Pf3D7_10_v3,69349,1227765,1158416
SMI004-K03-B01-M02,1,2,Pf3D7_11_v3,493315,921603,428288
SMI004-K03-B01-M02,1,2,Pf3D7_12_v3,181119,576039,394920
SMI004-K03-B01-M02,1,2,Pf3D7_12_v3,646451,892951,246500
SMI004-K03-B01-M02,1,2,Pf3D7_12_v3,1367715,1588376,220661
SMI004-K03-B01-M02,1,2,Pf3D7_12_v3,1778367,1861003,82636
SMI004-K03-B01-M02,1,2,Pf3D7_12_v3,1924730,2163685,238955
SMI004-K03-B01-M02,1,2,Pf3D7_13_v3,74436,793453,719017
SMI004-K03-B01-M02,1,2,Pf3D7_13_v3,1511677,2640333,1128656
SMI004-K03-B01-M02,1,2,Pf3D7_13_v3,2648084,2791755,143671
SMI004-K03-B01-M02,1,2,Pf3D7_14_v3,35796,135456,99660
SMI004-K03-B01-M02,1,2,Pf3D7_14_v3,746994,1033182,286188
SMI004-K03-B01-M02,1,2,Pf3D7_14_v3,1393166,1556728,163562
SMI004-K03-B01-M02,1,2,Pf3D7_14_v3,1723267,2968044,1244777
SMI004-K03-B01-M02,1,2,Pf3D7_14_v3,3216241,3255707,39466
SMI006-K03-B02-M02,0,1,Pf3D7_01_v3,162678,575569,412891
SMI006-K03-B02-M02,0,1,Pf3D7_02_v3,106095,862487,756392
SMI006-K03-B02-M02,0,1,Pf3D7_03_v3,70645,1002873,932228
SMI006-K03-B02-M02,0,1,Pf3D7_04_v3,91421,101659,10238
SMI006-K03-B02-M02,0,1,Pf3D7_04_v3,1100716,1143943,43227
SMI006-K03-B02-M02,0,1,Pf3D7_05_v3,38009,1252815,1214806
SMI006-K03-B02-M02,0,1,Pf3D7_06_v3,192053,1126350,934297
SMI006-K03-B02-M02,0,1,Pf3D7_07_v3,468540,1381532,912992
SMI006-K03-B02-M02,0,1,Pf3D7_08_v3,73645,245563,171918
SMI006-K03-B02-M02,0,1,Pf3D7_08_v3,317139,1364861,1047722
SMI006-K03-B02-M02,0,1,Pf3D7_09_v3,79899,517157,437258
SMI006-K03-B02-M02,0,1,Pf3D7_09_v3,522364,531892,9528
SMI006-K03-B02-M02,0,1,Pf3D7_09_v3,863928,1473498,609570
SMI006-K03-B02-M02,0,1,Pf3D7_10_v3,69349,305179,235830
SMI006-K03-B02-M02,0,1,Pf3D7_10_v3,606909,895091,288182
SMI006-K03-B02-M02,0,1,Pf3D7_10_v3,1086127,1571493,485366
SMI006-K03-B02-M02,0,1,Pf3D7_11_v3,110021,453458,343437
SMI006-K03-B02-M02,0,1,Pf3D7_11_v3,499865,617851,117986
SMI006-K03-B02-M02,0,1,Pf3D7_11_v3,651236,670528,19292
SMI006-K03-B02-M02,0,1,Pf3D7_11_v3,706605,773961,67356
SMI006-K03-B02-M02,0,1,Pf3D7_11_v3,819452,1374796,555344
SMI006-K03-B02-M02,0,1,Pf3D7_12_v3,266177,1561003,1294826
SMI006-K03-B02-M02,0,1,Pf3D7_12_v3,1759114,2163685,404571
SMI006-K03-B02-M02,0,1,Pf3D7_13_v3,74436,793453,719017
SMI006-K03-B02-M02,0,1,Pf3D7_13_v3,1755940,2391995,636055
SMI006-K03-B02-M02,0,1,Pf3D7_13_v3,2648084,2791755,143671
SMI006-K03-B02-M02,0,1,Pf3D7_14_v3,35796,912071,876275
SMI006-K03-B02-M02,0,1,Pf3D7_14_v3,1158277,1827458,669181
SMI006-K03-B02-M02,0,1,Pf3D7_14_v3,2083563,2835807,752244
SMI006-K03-B02-M02,0,1,Pf3D7_14_v3,3216498,3255707,39209
SMI007-K03-B01-M01,0,1,Pf3D7_01_v3,92914,355243,262329
SMI007-K03-B01-M01,0,1,Pf3D7_06_v3,1237708,1294804,57096
SMI007-K03-B01-M01,0,1,Pf3D7_07_v3,77107,723277,646170
SMI007-K03-B01-M01,0,1,Pf3D7_10_v3,372819,606909,234090
SMI007-K03-B01-M01,0,1,Pf3D7_11_v3,463909,1267979,804070
SMI007-K03-B01-M01,0,1,Pf3D7_11_v3,1983685,2003304,19619
SMI007-K03-B01-M01,0,1,Pf3D7_12_v3,60438,2163685,2103247
SMI007-K03-B01-M01,0,1,Pf3D7_13_v3,74436,85226,10790
SMI007-K03-B01-M01,0,1,Pf3D7_13_v3,1864871,2312240,447369
SMI007-K03-B01-M01,0,1,Pf3D7_13_v3,2710288,2791755,81467
SMI007-K03-B01-M01,0,1,Pf3D7_14_v3,35796,139991,104195
SMI007-K03-B01-M01,0,1,Pf3D7_14_v3,1033182,1687397,654215
SMI007-K03-B01-M01,0,2,Pf3D7_01_v3,355243,575569,220326
SMI007-K03-B01-M01,0,2,Pf3D7_02_v3,106095,665889,559794
SMI007-K03-B01-M01,0,2,Pf3D7_02_v3,695452,862487,167035
SMI007-K03-B01-M01,0,2,Pf3D7_03_v3,70645,696427,625782
SMI007-K03-B01-M01,0,2,Pf3D7_04_v3,1018803,1143943,125140
SMI007-K03-B01-M01,0,2,Pf3D7_05_v3,38009,824094,786085
SMI007-K03-B01-M01,0,2,Pf3D7_05_v3,1252815,1321344,68529
SMI007-K03-B01-M01,0,2,Pf3D7_06_v3,72403,930617,858214
SMI007-K03-B01-M01,0,2,Pf3D7_11_v3,268825,453458,184633
SMI007-K03-B01-M01,0,2,Pf3D7_13_v3,85226,793453,708227
SMI007-K03-B01-M01,0,2,Pf3D7_14_v3,139991,1033182,893191
SMI007-K03-B01-M01,0,2,Pf3D7_14_v3,1687397,1723267,35870
SMI007-K03-B01-M01,0,2,Pf3D7_14_v3,2083563,3255707,1172144
SMI007-K03-B01-M01,1,2,Pf3D7_07_v3,941786,976806,35020
SMI007-K03-B01-M01,1,2,Pf3D7_07_v3,1252894,1381532,128638
SMI007-K03-B01-M01,1,2,Pf3D7_08_v3,73645,580774,507129
SMI007-K03-B01-M01,1,2,Pf3D7_09_v3,926412,1473498,547086
SMI007-K03-B01-M01,1,2,Pf3D7_10_v3,69349,247771,178422
SMI007-K03-B01-M01,1,2,Pf3D7_11_v3,1444786,1983685,538899
SMI007-K03-B01-M01,1,2,Pf3D7_13_v3,793453,1056452,262999
SMI007-K03-B01-M01,1,2,Pf3D7_13_v3,2312240,2710288,398048
SMI007-K03-B01-M01,1,2,Pf3D7_14_v3,1723267,1992710,269443
SMI008-K03-B01-M02,0,1,Pf3D7_01_v3,92914,575569,482655
SMI008-K03-B01-M02,0,1,Pf3D7_02_v3,106095,152746,46651
SMI008-K03-B01-M02,0,1,Pf3D7_02_v3,476879,617694,140815
SMI008-K03-B01-M02,0,1,Pf3D7_02_v3,665889,862487,196598
SMI008-K03-B01-M02,0,1,Pf3D7_03_v3,70645,387568,316923
SMI008-K03-B01-M02,0,1,Pf3D7_03_v3,684921,730833,45912
SMI008-K03-B01-M02,0,1,Pf3D7_04_v3,831694,1143943,312249
SMI008-K03-B01-M02,0,1,Pf3D7_05_v3,38009,1321344,1283335
SMI008-K03-B01-M02,0,1,Pf3D7_06_v3,72403,815233,742830
SMI008-K03-B01-M02,0,1,Pf3D7_07_v3,1319991,1381532,61541
SMI008-K03-B01-M02,0,1,Pf3D7_08_v3,73645,113095,39450
SMI008-K03-B01-M02,0,1,Pf3D7_08_v3,317139,906873,589734
SMI008-K03-B01-M02,0,1,Pf3D7_09_v3,260932,267990,7058
SMI008-K03-B01-M02,0,1,Pf3D7_09_v3,282699,863928,581229
SMI008-K03-B01-M02,0,1,Pf3D7_09_v3,995744,1473498,477754
SMI008-K03-B01-M02,0,1,Pf3D7_10_v3,69349,606909,537560
SMI008-K03-B01-M02,0,1,Pf3D7_10_v3,1373425,1571493,198068
SMI008-K03-B01-M02,0,1,Pf3D7_11_v3,110021,966984,856963
SMI008-K03-B01-M02,0,1,Pf3D7_11_v3,1374796,1560210,185414
SMI008-K03-B01-M02,0,1,Pf3D7_11_v3,1596786,2003304,406518
SMI008-K03-B01-M02,0,1,Pf3D7_12_v3,60438,116802,56364
SMI008-K03-B01-M02,0,1,Pf3D7_12_v3,1561003,1848191,287188
SMI008-K03-B01-M02,0,1,Pf3D7_13_v3,866111,1119784,253673
SMI008-K03-B01-M02,0,1,Pf3D7_13_v3,1493576,1721455,227879
SMI008-K03-B01-M02,0,1,Pf3D7_13_v3,1738178,1989791,251613
SMI008-K03-B01-M02,0,1,Pf3D7_13_v3,2135007,2212144,77137
SMI008-K03-B01-M02,0,1,Pf3D7_13_v3,2276261,2648084,371823
SMI008-K03-B01-M02,0,1,Pf3D7_14_v3,95153,1362977,1267824
SMI008-K03-B01-M02,0,1,Pf3D7_14_v3,1723267,2835807,1112540
SMI008-K03-B01-M02,0,1,Pf3D7_14_v3,3210699,3255707,45008
SMI008-K03-B01-M02,0,2,Pf3D7_02_v3,476879,617694,140815
SMI008-K03-B01-M02,0,2,Pf3D7_03_v3,619218,684921,65703
SMI008-K03-B01-M02,0,2,Pf3D7_03_v3,730833,1002873,272040
SMI008-K03-B01-M02,0,2,Pf3D7_04_v3,91421,166692,75271
SMI008-K03-B01-M02,0,2,Pf3D7_04_v3,1100716,1143943,43227
SMI008-K03-B01-M02,0,2,Pf3D7_05_v3,38009,1252815,1214806
SMI008-K03-B01-M02,0,2,Pf3D7_07_v3,992690,1381532,388842
SMI008-K03-B01-M02,0,2,Pf3D7_08_v3,73645,304369,230724
SMI008-K03-B01-M02,0,2,Pf3D7_08_v3,317139,906873,589734
SMI008-K03-B01-M02,0,2,Pf3D7_09_v3,260932,267990,7058
SMI008-K03-B01-M02,0,2,Pf3D7_10_v3,614971,1571493,956522
SMI008-K03-B01-M02,0,2,Pf3D7_11_v3,110021,796779,686758
SMI008-K03-B01-M02,0,2,Pf3D7_11_v3,1374796,1560210,185414
SMI008-K03-B01-M02,0,2,Pf3D7_12_v3,258411,280441,22030
SMI008-K03-B01-M02,0,2,Pf3D7_12_v3,528878,826301,297423
SMI008-K03-B01-M02,0,2,Pf3D7_12_v3,1462816,1561003,98187
SMI008-K03-B01-M02,0,2,Pf3D7_13_v3,452326,866111,413785
SMI008-K03-B01-M02,0,2,Pf3D7_13_v3,1989791,1998753,8962
SMI008-K03-B01-M02,0,2,Pf3D7_13_v3,2276261,2791755,515494
SMI008-K03-B01-M02,0,2,Pf3D7_14_v3,35796,325549,289753
SMI008-K03-B01-M02,0,2,Pf3D7_14_v3,1033182,1107599,74417
SMI008-K03-B01-M02,0,2,Pf3D7_14_v3,1723267,3210699,1487432
SMI008-K03-B01-M02,1,2,Pf3D7_02_v3,152746,665889,513143
SMI008-K03-B01-M02,1,2,Pf3D7_03_v3,387568,619218,231650
SMI008-K03-B01-M02,1,2,Pf3D7_04_v3,166692,831694,665002
SMI008-K03-B01-M02,1,2,Pf3D7_04_v3,1100716,1143943,43227
SMI008-K03-B01-M02,1,2,Pf3D7_05_v3,38009,1252815,1214806
SMI008-K03-B01-M02,1,2,Pf3D7_06_v3,815233,1294804,479571
SMI008-K03-B01-M02,1,2,Pf3D7_07_v3,77107,992690,915583
SMI008-K03-B01-M02,1,2,Pf3D7_07_v3,1319991,1381532,61541
SMI008-K03-B01-M02,1,2,Pf3D7_08_v3,73645,113095,39450
SMI008-K03-B01-M02,1,2,Pf3D7_08_v3,304369,1364861,1060492
SMI008-K03-B01-M02,1,2,Pf3D7_09_v3,79899,282699,202800
SMI008-K03-B01-M02,1,2,Pf3D7_09_v3,863928,995744,131816
SMI008-K03-B01-M02,1,2,Pf3D7_10_v3,606909,614971,8062
SMI008-K03-B01-M02,1,2,Pf3D7_10_v3,1373425,1571493,198068
SMI008-K03-B01-M02,1,2,Pf3D7_11_v3,110021,796779,686758
SMI008-K03-B01-M02,1,2,Pf3D7_11_v3,966984,1596786,629802
SMI008-K03-B01-M02,1,2,Pf3D7_12_v3,116802,258411,141609
SMI008-K03-B01-M02,1,2,Pf3D7_12_v3,280441,528878,248437
SMI008-K03-B01-M02,1,2,Pf3D7_12_v3,826301,1462816,636515
SMI008-K03-B01-M02,1,2,Pf3D7_12_v3,1848191,2163685,315494
SMI008-K03-B01-M02,1,2,Pf3D7_13_v3,74436,452326,377890
SMI008-K03-B01-M02,1,2,Pf3D7_13_v3,1119784,1493576,373792
SMI008-K03-B01-M02,1,2,Pf3D7_13_v3,1721455,1738178,16723
SMI008-K03-B01-M02,1,2,Pf3D7_13_v3,1998753,2135007,136254
SMI008-K03-B01-M02,1,2,Pf3D7_13_v3,2212144,2648084,435940
SMI008-K03-B01-M02,1,2,Pf3D7_14_v3,95153,325549,230396
SMI008-K03-B01-M02,1,2,Pf3D7_14_v3,1033182,1107599,74417
SMI008-K03-B01-M02,1,2,Pf3D7_14_v3,1362977,2835807,1472830
SMI000-K04-B03-M01,0,1,Pf3D7_03_v3,501876,1002873,500997
SMI000-K04-B03-M01,0,1,Pf3D7_04_v3,91421,1143943,1052522
SMI000-K04-B03-M01,0,1,Pf3D7_05_v3,38009,1252815,1214806
SMI000-K04-B03-M01,0,1,Pf3D7_05_v3,1298024,1321344,23320
SMI000-K04-B03-M01,0,1,Pf3D7_06_v3,72403,930617,858214
SMI000-K04-B03-M01,0,1,Pf3D7_07_v3,916642,919731,3089
SMI000-K04-B03-M01,0,1,Pf3D7_08_v3,127656,1364861,1237205
SMI000-K04-B03-M01,0,1,Pf3D7_09_v3,79899,863928,784029
SMI000-K04-B03-M01,0,1,Pf3D7_09_v3,990105,1424328,434223
SMI000-K04-B03-M01,0,1,Pf3D7_10_v3,606909,645020,38111
SMI000-K04-B03-M01,0,1,Pf3D7_10_v3,1343098,1465691,122593
SMI000-K04-B03-M01,0,1,Pf3D7_11_v3,149031,453458,304427
SMI000-K04-B03-M01,0,1,Pf3D7_13_v3,1605325,2791755,1186430
SMI000-K04-B03-M01,0,1,Pf3D7_14_v3,35796,798615,762819
SMI000-K04-B03-M01,0,1,Pf3D7_14_v3,1033182,1723267,690085
SMI000-K04-B03-M01,0,1,Pf3D7_14_v3,1891821,2083563,191742
SMI000-K04-B03-M01,0,1,Pf3D7_14_v3,2444718,2613932,169214
SMI001-K04-B02-M03,0,1,Pf3D7_01_v3,92914,575569,482655
SMI001-K04-B02-M03,0,1,Pf3D7_02_v3,106095,862487,756392
SMI001-K04-B02-M03,0,1,Pf3D7_03_v3,70645,266397,195752
SMI001-K04-B02-M03,0,1,Pf3D7_03_v3,783387,1002873,219486
SMI001-K04-B02-M03,0,1,Pf3D7_04_v3,91421,1143943,1052522
SMI001-K04-B02-M03,0,1,Pf3D7_05_v3,38009,1252815,1214806
SMI001-K04-B02-M03,0,1,Pf3D7_06_v3,136309,1294804,1158495
SMI001-K04-B02-M03,0,1,Pf3D7_07_v3,77107,1381532,1304425
SMI001-K04-B02-M03,0,1,Pf3D7_08_v3,73645,1258050,1184405
SMI001-K04-B02-M03,0,1,Pf3D7_09_v3,364649,1473498,1108849
SMI001-K04-B02-M03,0,1,Pf3D7_10_v3,69349,162688,93339
SMI001-K04-B02-M03,0,1,Pf3D7_10_v3,606909,1397838,790929
SMI001-K04-B02-M03,0,1,Pf3D7_11_v3,227082,1323842,1096760
SMI001-K04-B02-M03,0,1,Pf3D7_12_v3,654304,665510,11206
SMI001-K04-B02-M03,0,1,Pf3D7_12_v3,1299027,2149050,850023
SMI001-K04-B02-M03,0,1,Pf3D7_13_v3,509336,2791755,2282419
SMI001-K04-B02-M03,0,1,Pf3D7_14_v3,35796,68096,32300
SMI001-K04-B02-M03,0,1,Pf3D7_14_v3,158049,311604,153555
SMI001-K04-B02-M03,0,1,Pf3D7_14_v3,434820,1109886,675066
SMI001-K04-B02-M03,0,1,Pf3D7_14_v3,1312719,1572684,259965
SMI001-K04-B02-M03,0,1,Pf3D7_14_v3,1723267,1809545,86278
SMI001-K04-B02-M03,0,1,Pf3D7_14_v3,1831685,1994672,162987
SMI001-K04-B02-M03,0,1,Pf3D7_14_v3,2022906,2824030,801124
SMI001-K04-B02-M03,0,1,Pf3D7_14_v3,2835807,3255707,419900
SMI001-K04-B02-M03,0,1,Pf3D7_01_v3,92914,575569,482655
SMI001-K04-B02-M03,0,1,Pf3D7_02_v3,106095,862487,756392
SMI001-K04-B02-M03,0,1,Pf3D7_03_v3,70645,1002873,932228
SMI001-K04-B02-M03,0,1,Pf3D7_04_v3,91421,1101872,1010451
SMI001-K04-B02-M03,0,1,Pf3D7_05_v3,208950,1321344,1112394
SMI001-K04-B02-M03,0,1,Pf3D7_06_v3,72403,1294804,1222401
SMI001-K04-B02-M03,0,1,Pf3D7_07_v3,77107,150008,72901
SMI001-K04-B02-M03,0,1,Pf3D7_07_v3,893290,1381532,488242
SMI001-K04-B02-M03,0,1,Pf3D7_08_v3,73645,501939,428294
SMI001-K04-B02-M03,0,1,Pf3D7_08_v3,571923,1364861,792938
SMI001-K04-B02-M03,0,1,Pf3D7_09_v3,79899,1203706,1123807
SMI001-K04-B02-M03,0,1,Pf3D7_10_v3,205282,1571493,1366211
SMI001-K04-B02-M03,0,1,Pf3D7_11_v3,110021,2003304,1893283
SMI001-K04-B02-M03,0,1,Pf3D7_12_v3,60438,665510,605072
SMI001-K04-B02-M03,0,1,Pf3D7_12_v3,1365397,1367715,2318
SMI001-K04-B02-M03,0,1,Pf3D7_12_v3,1843287,1963275,119988
SMI001-K04-B02-M03,0,1,Pf3D7_12_v3,2116712,2163685,46973
SMI001-K04-B02-M03,0,1,Pf3D7_13_v3,74436,2193207,2118771
SMI001-K04-B02-M03,0,1,Pf3D7_13_v3,2637864,2791755,153891
SMI001-K04-B02-M03,0,1,Pf3D7_14_v3,35796,2083563,2047767
SMI001-K04-B02-M03,0,1,Pf3D7_14_v3,2116057,2835807,719750
SMI001-K04-B02-M03,0,1,Pf3D7_14_v3,2933341,3255707,322366
SMI004-K04-B03-M02,0,1,Pf3D7_01_v3,92914,575569,482655
SMI004-K04-B03-M02,0,1,Pf3D7_02_v3,106095,791595,685500
SMI004-K04-B03-M02,0,1,Pf3D7_03_v3,170434,1002873,832439
SMI004-K04-B03-M02,0,1,Pf3D7_04_v3,91421,1143943,1052522
SMI004-K04-B03-M02,0,1,Pf3D7_05_v3,38009,1252815,1214806
SMI004-K04-B03-M02,0,1,Pf3D7_06_v3,664095,1130390,466295
SMI004-K04-B03-M02,0,1,Pf3D7_07_v3,749859,1381532,631673
SMI004-K04-B03-M02,0,1,Pf3D7_08_v3,73645,495989,422344
SMI004-K04-B03-M02,0,1,Pf3D7_08_v3,782378,906873,124495
SMI004-K04-B03-M02,0,1,Pf3D7_09_v3,186979,1473498,1286519
SMI004-K04-B03-M02,0,1,Pf3D7_10_v3,69349,1571493,1502144
SMI004-K04-B03-M02,0,1,Pf3D7_11_v3,110021,1414476,1304455
SMI004-K04-B03-M02,0,1,Pf3D7_11_v3,1682370,2003304,320934
SMI004-K04-B03-M02,0,1,Pf3D7_12_v3,60438,258411,197973
SMI004-K04-B03-M02,0,1,Pf3D7_12_v3,466815,793870,327055
SMI004-K04-B03-M02,0,1,Pf3D7_12_v3,1367715,1950340,582625
SMI004-K04-B03-M02,0,1,Pf3D7_12_v3,2054623,2071367,16744
SMI004-K04-B03-M02,0,1,Pf3D7_12_v3,2149050,2163685,14635
SMI004-K04-B03-M02,0,1,Pf3D7_13_v3,74436,1937823,1863387
SMI004-K04-B03-M02,0,1,Pf3D7_13_v3,2193207,2791755,598548
SMI004-K04-B03-M02,0,1,Pf3D7_14_v3,35796,441949,406153
SMI004-K04-B03-M02,0,1,Pf3D7_14_v3,912071,1033182,121111
SMI004-K04-B03-M02,0,1,Pf3D7_14_v3,1355512,1556728,201216
SMI004-K04-B03-M02,0,1,Pf3D7_14_v3,1690248,1723267,33019
SMI004-K04-B03-M02,0,1,Pf3D7_14_v3,2071355,2083563,12208
SMI004-K04-B03-M02,0,1,Pf3D7_14_v3,2104321,2355352,251031
SMI004-K04-B03-M02,0,1,Pf3D7_14_v3,2672396,3255707,583311
SMI005-K04-B01-M03,0,1,Pf3D7_01_v3,270312,575569,305257
SMI005-K04-B01-M03,0,1,Pf3D7_02_v3,106095,588001,481906
SMI005-K04-B01-M03,0,1,Pf3D7_02_v3,665889,722512,56623
SMI005-K04-B01-M03,0,1,Pf3D7_04_v3,161980,772271,610291
SMI005-K04-B01-M03,0,1,Pf3D7_05_v3,174069,1321344,1147275
SMI005-K04-B01-M03,0,1,Pf3D7_06_v3,72403,114315,41912
SMI005-K04-B01-M03,0,1,Pf3D7_06_v3,930617,1294804,364187
SMI005-K04-B01-M03,0,1,Pf3D7_07_v3,77107,1119340,1042233
SMI005-K04-B01-M03,0,1,Pf3D7_07_v3,1185719,1381532,195813
SMI005-K04-B01-M03,0,1,Pf3D7_08_v3,73645,317139,243494
SMI005-K04-B01-M03,0,1,Pf3D7_08_v3,400278,906873,506595
SMI005-K04-B01-M03,0,1,Pf3D7_08_v3,1186275,1364861,178586
SMI005-K04-B01-M03,0,1,Pf3D7_09_v3,79899,863928,784029
SMI005-K04-B01-M03,0,1,Pf3D7_10_v3,305179,543779,238600
SMI005-K04-B01-M03,0,1,Pf3D7_10_v3,1427933,1571493,143560
SMI005-K04-B01-M03,0,1,Pf3D7_11_v3,110021,680955,570934
SMI005-K04-B01-M03,0,1,Pf3D7_11_v3,975176,1800949,825773
SMI005-K04-B01-M03,0,1,Pf3D7_12_v3,949846,1059172,109326
SMI005-K04-B01-M03,0,1,Pf3D7_12_v3,1374448,2163685,789237
SMI005-K04-B01-M03,0,1,Pf3D7_13_v3,74436,196236,121800
SMI005-K04-B01-M03,0,1,Pf3D7_13_v3,932093,2038033,1105940
SMI005-K04-B01-M03,0,1,Pf3D7_13_v3,2123556,2193207,69651
SMI005-K04-B01-M03,0,1,Pf3D7_13_v3,2602209,2648084,45875
SMI005-K04-B01-M03,0,1,Pf3D7_14_v3,267839,1202365,934526
SMI005-K04-B01-M03,0,1,Pf3D7_14_v3,1556728,1819017,262289
SMI005-K04-B01-M03,0,1,Pf3D7_14_v3,1856573,2563223,706650
SMI005-K04-B01-M03,0,1,Pf3D7_14_v3,2835807,3255707,419900
SMI005-K04-B01-M03,0,2,Pf3D7_01_v3,92914,575569,482655
SMI005-K04-B01-M03,0,2,Pf3D7_02_v3,106095,665889,559794
SMI005-K04-B01-M03,0,2,Pf3D7_03_v3,821208,1002873,181665
SMI005-K04-B01-M03,0,2,Pf3D7_04_v3,91421,141315,49894
SMI005-K04-B01-M03,0,2,Pf3D7_04_v3,161980,772271,610291
SMI005-K04-B01-M03,0,2,Pf3D7_04_v3,1135298,1143943,8645
SMI005-K04-B01-M03,0,2,Pf3D7_05_v3,38009,1321344,1283335
SMI005-K04-B01-M03,0,2,Pf3D7_06_v3,72403,114315,41912
SMI005-K04-B01-M03,0,2,Pf3D7_06_v3,664555,1294804,630249
SMI005-K04-B01-M03,0,2,Pf3D7_07_v3,77107,1119340,1042233
SMI005-K04-B01-M03,0,2,Pf3D7_07_v3,1185719,1381532,195813
SMI005-K04-B01-M03,0,2,Pf3D7_08_v3,73645,317139,243494
SMI005-K04-B01-M03,0,2,Pf3D7_08_v3,400278,906873,506595
SMI005-K04-B01-M03,0,2,Pf3D7_08_v3,1213316,1364861,151545
SMI005-K04-B01-M03,0,2,Pf3D7_09_v3,79899,399686,319787
SMI005-K04-B01-M03,0,2,Pf3D7_09_v3,647270,863928,216658
SMI005-K04-B01-M03,0,2,Pf3D7_10_v3,178314,1427933,1249619
SMI005-K04-B01-M03,0,2,Pf3D7_11_v3,453458,680955,227497
SMI005-K04-B01-M03,0,2,Pf3D7_11_v3,975176,2003304,1028128
SMI005-K04-B01-M03,0,2,Pf3D7_12_v3,60438,1153797,1093359
SMI005-K04-B01-M03,0,2,Pf3D7_12_v3,1374448,2163685,789237
SMI005-K04-B01-M03,0,2,Pf3D7_13_v3,74436,196236,121800
SMI005-K04-B01-M03,0,2,Pf3D7_13_v3,281373,793453,512080
SMI005-K04-B01-M03,0,2,Pf3D7_13_v3,932093,2343499,1411406
SMI005-K04-B01-M03,0,2,Pf3D7_13_v3,2602209,2791755,189546
SMI005-K04-B01-M03,0,2,Pf3D7_14_v3,35796,267839,232043
SMI005-K04-B01-M03,0,2,Pf3D7_14_v3,609248,912071,302823
SMI005-K04-B01-M03,0,2,Pf3D7_14_v3,1033182,1348573,315391
SMI005-K04-B01-M03,0,2,Pf3D7_14_v3,1556728,1723267,166539
SMI005-K04-B01-M03,0,2,Pf3D7_14_v3,1819017,3255707,1436690
SMI005-K04-B01-M03,0,3,Pf3D7_01_v3,270312,575569,305257
SMI005-K04-B01-M03,0,3,Pf3D7_02_v3,106095,588001,481906
SMI005-K04-B01-M03,0,3,Pf3D7_02_v3,722512,862487,139975
SMI005-K04-B01-M03,0,3,Pf3D7_03_v3,70645,821208,750563
SMI005-K04-B01-M03,0,3,Pf3D7_04_v3,141315,1135298,993983
SMI005-K04-B01-M03,0,3,Pf3D7_05_v3,174069,1321344,1147275
SMI005-K04-B01-M03,0,3,Pf3D7_06_v3,72403,664555,592152
SMI005-K04-B01-M03,0,3,Pf3D7_06_v3,930617,1294804,364187
SMI005-K04-B01-M03,0,3,Pf3D7_07_v3,77107,1381532,1304425
SMI005-K04-B01-M03,0,3,Pf3D7_08_v3,73645,1186275,1112630
SMI005-K04-B01-M03,0,3,Pf3D7_08_v3,1213316,1364861,151545
SMI005-K04-B01-M03,0,3,Pf3D7_09_v3,79899,399686,319787
SMI005-K04-B01-M03,0,3,Pf3D7_09_v3,647270,1473498,826228
SMI005-K04-B01-M03,0,3,Pf3D7_10_v3,69349,178314,108965
SMI005-K04-B01-M03,0,3,Pf3D7_10_v3,305179,543779,238600
SMI005-K04-B01-M03,0,3,Pf3D7_11_v3,453458,1800949,1347491
SMI005-K04-B01-M03,0,3,Pf3D7_12_v3,949846,1059172,109326
SMI005-K04-B01-M03,0,3,Pf3D7_12_v3,1153797,2163685,1009888
SMI005-K04-B01-M03,0,3,Pf3D7_13_v3,74436,281373,206937
SMI005-K04-B01-M03,0,3,Pf3D7_13_v3,793453,2038033,1244580
SMI005-K04-B01-M03,0,3,Pf3D7_13_v3,2123556,2193207,69651
SMI005-K04-B01-M03,0,3,Pf3D7_13_v3,2343499,2648084,304585
SMI005-K04-B01-M03,0,3,Pf3D7_14_v3,609248,912071,302823
SMI005-K04-B01-M03,0,3,Pf3D7_14_v3,1033182,1202365,169183
SMI005-K04-B01-M03,0,3,Pf3D7_14_v3,1348573,1723267,374694
SMI005-K04-B01-M03,0,3,Pf3D7_14_v3,1856573,2563223,706650
SMI005-K04-B01-M03,0,3,Pf3D7_14_v3,2835807,3255707,419900
SMI005-K04-B01-M03,1,2,Pf3D7_01_v3,270312,575569,305257
SMI005-K04-B01-M03,1,2,Pf3D7_02_v3,106095,588001,481906
SMI005-K04-B01-M03,1,2,Pf3D7_02_v3,722512,862487,139975
SMI005-K04-B01-M03,1,2,Pf3D7_03_v3,70645,821208,750563
SMI005-K04-B01-M03,1,2,Pf3D7_04_v3,141315,1135298,993983
SMI005-K04-B01-M03,1,2,Pf3D7_05_v3,174069,1321344,1147275
SMI005-K04-B01-M03,1,2,Pf3D7_06_v3,72403,664555,592152
SMI005-K04-B01-M03,1,2,Pf3D7_06_v3,930617,1294804,364187
SMI005-K04-B01-M03,1,2,Pf3D7_07_v3,77107,1381532,1304425
SMI005-K04-B01-M03,1,2,Pf3D7_08_v3,73645,1186275,1112630
SMI005-K04-B01-M03,1,2,Pf3D7_08_v3,1213316,1364861,151545
SMI005-K04-B01-M03,1,2,Pf3D7_09_v3,79899,399686,319787
SMI005-K04-B01-M03,1,2,Pf3D7_09_v3,647270,1473498,826228
SMI005-K04-B01-M03,1,2,Pf3D7_10_v3,69349,178314,108965
SMI005-K04-B01-M03,1,2,Pf3D7_10_v3,305179,543779,238600
SMI005-K04-B01-M03,1,2,Pf3D7_11_v3,453458,1800949,1347491
SMI005-K04-B01-M03,1,2,Pf3D7_12_v3,949846,1059172,109326
SMI005-K04-B01-M03,1,2,Pf3D7_12_v3,1153797,2163685,1009888
SMI005-K04-B01-M03,1,2,Pf3D7_13_v3,74436,281373,206937
SMI005-K04-B01-M03,1,2,Pf3D7_13_v3,793453,2038033,1244580
SMI005-K04-B01-M03,1,2,Pf3D7_13_v3,2123556,2193207,69651
SMI005-K04-B01-M03,1,2,Pf3D7_13_v3,2343499,2648084,304585
SMI005-K04-B01-M03,1,2,Pf3D7_14_v3,609248,912071,302823
SMI005-K04-B01-M03,1,2,Pf3D7_14_v3,1033182,1202365,169183
SMI005-K04-B01-M03,1,2,Pf3D7_14_v3,1348573,1723267,374694
SMI005-K04-B01-M03,1,2,Pf3D7_14_v3,1856573,2563223,706650
SMI005-K04-B01-M03,1,2,Pf3D7_14_v3,2835807,3255707,419900
SMI005-K04-B01-M03,1,3,Pf3D7_01_v3,92914,575569,482655
SMI005-K04-B01-M03,1,3,Pf3D7_02_v3,106095,665889,559794
SMI005-K04-B01-M03,1,3,Pf3D7_03_v3,821208,1002873,181665
SMI005-K04-B01-M03,1,3,Pf3D7_04_v3,91421,141315,49894
SMI005-K04-B01-M03,1,3,Pf3D7_04_v3,161980,772271,610291
SMI005-K04-B01-M03,1,3,Pf3D7_04_v3,1135298,1143943,8645
SMI005-K04-B01-M03,1,3,Pf3D7_05_v3,38009,1321344,1283335
SMI005-K04-B01-M03,1,3,Pf3D7_06_v3,72403,114315,41912
SMI005-K04-B01-M03,1,3,Pf3D7_06_v3,664555,1294804,630249
SMI005-K04-B01-M03,1,3,Pf3D7_07_v3,77107,1119340,1042233
SMI005-K04-B01-M03,1,3,Pf3D7_07_v3,1185719,1381532,195813
SMI005-K04-B01-M03,1,3,Pf3D7_08_v3,73645,317139,243494
SMI005-K04-B01-M03,1,3,Pf3D7_08_v3,400278,906873,506595
SMI005-K04-B01-M03,1,3,Pf3D7_08_v3,1213316,1364861,151545
SMI005-K04-B01-M03,1,3,Pf3D7_09_v3,79899,399686,319787
SMI005-K04-B01-M03,1,3,Pf3D7_09_v3,647270,863928,216658
SMI005-K04-B01-M03,1,3,Pf3D7_10_v3,178314,1427933,1249619
SMI005-K04-B01-M03,1,3,Pf3D7_11_v3,453458,680955,227497
SMI005-K04-B01-M03,1,3,Pf3D7_11_v3,975176,2003304,1028128
SMI005-K04-B01-M03,1,3,Pf3D7_12_v3,60438,1153797,1093359
SMI005-K04-B01-M03,1,3,Pf3D7_12_v3,1374448,2163685,789237
SMI005-K04-B01-M03,1,3,Pf3D7_13_v3,74436,196236,121800
SMI005-K04-B01-M03,1,3,Pf3D7_13_v3,281373,793453,512080
SMI005-K04-B01-M03,1,3,Pf3D7_13_v3,932093,2343499,1411406
SMI005-K04-B01-M03,1,3,Pf3D7_13_v3,2602209,2791755,189546
SMI005-K04-B01-M03,1,3,Pf3D7_14_v3,35796,267839,232043
SMI005-K04-B01-M03,1,3,Pf3D7_14_v3,609248,912071,302823
SMI005-K04-B01-M03,1,3,Pf3D7_14_v3,1033182,1348573,315391
SMI005-K04-B01-M03,1,3,Pf3D7_14_v3,1556728,1723267,166539
SMI005-K04-B01-M03,1,3,Pf3D7_14_v3,1819017,3255707,1436690
SMI005-K04-B01-M03,2,3,Pf3D7_01_v3,270312,575569,305257
SMI005-K04-B01-M03,2,3,Pf3D7_02_v3,106095,588001,481906
SMI005-K04-B01-M03,2,3,Pf3D7_02_v3,665889,722512,56623
SMI005-K04-B01-M03,2,3,Pf3D7_04_v3,161980,772271,610291
SMI005-K04-B01-M03,2,3,Pf3D7_05_v3,174069,1321344,1147275
SMI005-K04-B01-M03,2,3,Pf3D7_06_v3,72403,114315,41912
SMI005-K04-B01-M03,2,3,Pf3D7_06_v3,930617,1294804,364187
SMI005-K04-B01-M03,2,3,Pf3D7_07_v3,77107,1119340,1042233
SMI005-K04-B01-M03,2,3,Pf3D7_07_v3,1185719,1381532,195813
SMI005-K04-B01-M03,2,3,Pf3D7_08_v3,73645,317139,243494
SMI005-K04-B01-M03,2,3,Pf3D7_08_v3,400278,906873,506595
SMI005-K04-B01-M03,2,3,Pf3D7_08_v3,1186275,1364861,178586
SMI005-K04-B01-M03,2,3,Pf3D7_09_v3,79899,863928,784029
SMI005-K04-B01-M03,2,3,Pf3D7_10_v3,305179,543779,238600
SMI005-K04-B01-M03,2,3,Pf3D7_10_v3,1427933,1571493,143560
SMI005-K04-B01-M03,2,3,Pf3D7_11_v3,110021,680955,570934
SMI005-K04-B01-M03,2,3,Pf3D7_11_v3,975176,1800949,825773
SMI005-K04-B01-M03,2,3,Pf3D7_12_v3,949846,1059172,109326
SMI005-K04-B01-M03,2,3,Pf3D7_12_v3,1374448,2163685,789237
SMI005-K04-B01-M03,2,3,Pf3D7_13_v3,74436,196236,121800
SMI005-K04-B01-M03,2,3,Pf3D7_13_v3,932093,2038033,1105940
SMI005-K04-B01-M03,2,3,Pf3D7_13_v3,2123556,2193207,69651
SMI005-K04-B01-M03,2,3,Pf3D7_13_v3,2602209,2648084,45875
SMI005-K04-B01-M03,2,3,Pf3D7_14_v3,267839,1202365,934526
SMI005-K04-B01-M03,2,3,Pf3D7_14_v3,1556728,1819017,262289
SMI005-K04-B01-M03,2,3,Pf3D7_14_v3,1856573,2563223,706650
SMI005-K04-B01-M03,2,3,Pf3D7_14_v3,2835807,3255707,419900
SMI006-K04-B02-M01,0,1,Pf3D7_02_v3,665889,756687,90798
SMI006-K04-B02-M01,0,1,Pf3D7_03_v3,432852,775543,342691
SMI006-K04-B02-M01,0,1,Pf3D7_05_v3,279885,348852,68967
SMI006-K04-B02-M01,0,1,Pf3D7_06_v3,321754,558309,236555
SMI006-K04-B02-M01,0,1,Pf3D7_06_v3,1124388,1294804,170416
SMI006-K04-B02-M01,0,1,Pf3D7_07_v3,77107,198915,121808
SMI006-K04-B02-M01,0,1,Pf3D7_08_v3,420586,1093675,673089
SMI006-K04-B02-M01,0,1,Pf3D7_09_v3,863928,995164,131236
SMI006-K04-B02-M01,0,1,Pf3D7_11_v3,834920,1549357,714437
SMI006-K04-B02-M01,0,1,Pf3D7_11_v3,1888082,2003304,115222
SMI006-K04-B02-M01,0,1,Pf3D7_12_v3,60438,2005259,1944821
SMI006-K04-B02-M01,0,1,Pf3D7_14_v3,1033182,1453597,420415
SMI006-K04-B02-M01,0,1,Pf3D7_14_v3,2061811,2083563,21752
SMI006-K04-B02-M01,0,1,Pf3D7_14_v3,2929857,3255707,325850
SMI006-K04-B02-M01,0,2,Pf3D7_02_v3,343540,612828,269288
SMI006-K04-B02-M01,0,2,Pf3D7_02_v3,756687,862487,105800
SMI006-K04-B02-M01,0,2,Pf3D7_03_v3,70645,432852,362207
SMI006-K04-B02-M01,0,2,Pf3D7_04_v3,129653,277698,148045
SMI006-K04-B02-M01,0,2,Pf3D7_04_v3,1100716,1143943,43227
SMI006-K04-B02-M01,0,2,Pf3D7_05_v3,38009,279885,241876
SMI006-K04-B02-M01,0,2,Pf3D7_05_v3,348852,1160852,812000
SMI006-K04-B02-M01,0,2,Pf3D7_05_v3,1246883,1252815,5932
SMI006-K04-B02-M01,0,2,Pf3D7_05_v3,1297160,1321344,24184
SMI006-K04-B02-M01,0,2,Pf3D7_06_v3,72403,558309,485906
SMI006-K04-B02-M01,0,2,Pf3D7_06_v3,682545,803623,121078
SMI006-K04-B02-M01,0,2,Pf3D7_06_v3,930617,1124388,193771
SMI006-K04-B02-M01,0,2,Pf3D7_07_v3,453959,982531,528572
SMI006-K04-B02-M01,0,2,Pf3D7_07_v3,1133722,1381532,247810
SMI006-K04-B02-M01,0,2,Pf3D7_08_v3,73645,420586,346941
SMI006-K04-B02-M01,0,2,Pf3D7_10_v3,104477,1383873,1279396
SMI006-K04-B02-M01,0,2,Pf3D7_11_v3,834920,1549357,714437
SMI006-K04-B02-M01,0,2,Pf3D7_11_v3,1888082,2003304,115222
SMI006-K04-B02-M01,0,2,Pf3D7_12_v3,60438,487426,426988
SMI006-K04-B02-M01,0,2,Pf3D7_12_v3,1068410,2005259,936849
SMI006-K04-B02-M01,0,2,Pf3D7_13_v3,363193,793453,430260
SMI006-K04-B02-M01,0,2,Pf3D7_13_v3,1750930,1929231,178301
SMI006-K04-B02-M01,0,2,Pf3D7_13_v3,2648084,2791755,143671
SMI006-K04-B02-M01,0,2,Pf3D7_14_v3,35796,1033182,997386
SMI006-K04-B02-M01,0,2,Pf3D7_14_v3,1416364,1453597,37233
SMI006-K04-B02-M01,0,2,Pf3D7_14_v3,1820490,2061811,241321
SMI006-K04-B02-M01,0,2,Pf3D7_14_v3,2083563,2895612,812049
SMI006-K04-B02-M01,1,2,Pf3D7_01_v3,92914,500164,407250
SMI006-K04-B02-M01,1,2,Pf3D7_06_v3,321754,682545,360791
SMI006-K04-B02-M01,1,2,Pf3D7_06_v3,803623,930617,126994
SMI006-K04-B02-M01,1,2,Pf3D7_07_v3,982531,1133722,151191
SMI006-K04-B02-M01,1,2,Pf3D7_10_v3,1383873,1571493,187620
SMI006-K04-B02-M01,1,2,Pf3D7_11_v3,110021,2003304,1893283
SMI006-K04-B02-M01,1,2,Pf3D7_12_v3,60438,487426,426988
SMI006-K04-B02-M01,1,2,Pf3D7_12_v3,1068410,2163685,1095275
SMI006-K04-B02-M01,1,2,Pf3D7_13_v3,74436,363193,288757
SMI006-K04-B02-M01,1,2,Pf3D7_13_v3,2112460,2648084,535624
SMI006-K04-B02-M01,1,2,Pf3D7_14_v3,1416364,1723267,306903
SMI007-K04-B01-M02,0,1,Pf3D7_02_v3,314816,465275,150459
SMI007-K04-B01-M02,0,1,Pf3D7_02_v3,588001,822248,234247
SMI007-K04-B01-M02,0,1,Pf3D7_03_v3,304034,1002873,698839
SMI007-K04-B01-M02,0,1,Pf3D7_04_v3,91421,1143943,1052522
SMI007-K04-B01-M02,0,1,Pf3D7_05_v3,38009,81966,43957
SMI007-K04-B01-M02,0,1,Pf3D7_05_v3,378369,1233436,855067
SMI007-K04-B01-M02,0,1,Pf3D7_06_v3,405955,928140,522185
SMI007-K04-B01-M02,0,1,Pf3D7_07_v3,80365,452710,372345
SMI007-K04-B01-M02,0,1,Pf3D7_07_v3,475917,1381532,905615
SMI007-K04-B01-M02,0,1,Pf3D7_08_v3,73645,848772,775127
SMI007-K04-B01-M02,0,1,Pf3D7_08_v3,906873,1364861,457988
SMI007-K04-B01-M02,0,1,Pf3D7_09_v3,79899,695926,616027
SMI007-K04-B01-M02,0,1,Pf3D7_09_v3,863928,1118520,254592
SMI007-K04-B01-M02,0,1,Pf3D7_10_v3,457074,677437,220363
SMI007-K04-B01-M02,0,1,Pf3D7_10_v3,1128949,1418003,289054
SMI007-K04-B01-M02,0,1,Pf3D7_11_v3,186888,2003304,1816416
SMI007-K04-B01-M02,0,1,Pf3D7_12_v3,60438,112586,52148
SMI007-K04-B01-M02,0,1,Pf3D7_12_v3,177169,256763,79594
SMI007-K04-B01-M02,0,1,Pf3D7_12_v3,358545,440940,82395
SMI007-K04-B01-M02,0,1,Pf3D7_12_v3,511911,820925,309014
SMI007-K04-B01-M02,0,1,Pf3D7_12_v3,869297,1064209,194912
SMI007-K04-B01-M02,0,1,Pf3D7_12_v3,1561003,1638465,77462
SMI007-K04-B01-M02,0,1,Pf3D7_12_v3,1670958,1877192,206234
SMI007-K04-B01-M02,0,1,Pf3D7_12_v3,2013870,2163685,149815
SMI007-K04-B01-M02,0,1,Pf3D7_13_v3,74436,793453,719017
SMI007-K04-B01-M02,0,1,Pf3D7_13_v3,2159995,2573651,413656
SMI007-K04-B01-M02,0,1,Pf3D7_14_v3,272898,429686,156788
SMI007-K04-B01-M02,0,1,Pf3D7_14_v3,665191,724841,59650
SMI007-K04-B01-M02,0,1,Pf3D7_14_v3,912071,1075834,163763
SMI007-K04-B01-M02,0,1,Pf3D7_14_v3,1723267,1816976,93709
SMI007-K04-B01-M02,0,1,Pf3D7_14_v3,1820417,1825842,5425
SMI007-K04-B01-M02,0,1,Pf3D7_14_v3,2083563,2576461,492898
SMI007-K04-B01-M02,0,1,Pf3D7_14_v3,2835807,2966924,131117
SMI007-K04-B01-M02,0,1,Pf3D7_14_v3,3216241,3255707,39466
SMI007-K04-B01-M02,0,2,Pf3D7_02_v3,203036,314816,111780
SMI007-K04-B01-M02,0,2,Pf3D7_02_v3,588001,665889,77888
SMI007-K04-B01-M02,0,2,Pf3D7_02_v3,822248,862487,40239
SMI007-K04-B01-M02,0,2,Pf3D7_03_v3,70645,335293,264648
SMI007-K04-B01-M02,0,2,Pf3D7_03_v3,494204,782284,288080
SMI007-K04-B01-M02,0,2,Pf3D7_04_v3,100024,1143943,1043919
SMI007-K04-B01-M02,0,2,Pf3D7_05_v3,38009,81966,43957
SMI007-K04-B01-M02,0,2,Pf3D7_05_v3,1233436,1252815,19379
SMI007-K04-B01-M02,0,2,Pf3D7_06_v3,206654,405955,199301
SMI007-K04-B01-M02,0,2,Pf3D7_06_v3,928140,930617,2477
SMI007-K04-B01-M02,0,2,Pf3D7_06_v3,1183288,1294804,111516
SMI007-K04-B01-M02,0,2,Pf3D7_07_v3,77107,202419,125312
SMI007-K04-B01-M02,0,2,Pf3D7_07_v3,234734,452710,217976
SMI007-K04-B01-M02,0,2,Pf3D7_07_v3,475917,1239953,764036
SMI007-K04-B01-M02,0,2,Pf3D7_08_v3,107133,638639,531506
SMI007-K04-B01-M02,0,2,Pf3D7_08_v3,906873,1364861,457988
SMI007-K04-B01-M02,0,2,Pf3D7_09_v3,79899,90339,10440
SMI007-K04-B01-M02,0,2,Pf3D7_09_v3,863928,1118520,254592
SMI007-K04-B01-M02,0,2,Pf3D7_10_v3,157307,305179,147872
SMI007-K04-B01-M02,0,2,Pf3D7_10_v3,457074,677437,220363
SMI007-K04-B01-M02,0,2,Pf3D7_10_v3,1128949,1418003,289054
SMI007-K04-B01-M02,0,2,Pf3D7_11_v3,186888,453458,266570
SMI007-K04-B01-M02,0,2,Pf3D7_11_v3,835226,1374796,539570
SMI007-K04-B01-M02,0,2,Pf3D7_11_v3,1799850,2003304,203454
SMI007-K04-B01-M02,0,2,Pf3D7_12_v3,60438,511911,451473
SMI007-K04-B01-M02,0,2,Pf3D7_12_v3,869297,1561003,691706
SMI007-K04-B01-M02,0,2,Pf3D7_12_v3,1638465,1670958,32493
SMI007-K04-B01-M02,0,2,Pf3D7_12_v3,1826163,1890273,64110
SMI007-K04-B01-M02,0,2,Pf3D7_12_v3,2013870,2163685,149815
SMI007-K04-B01-M02,0,2,Pf3D7_13_v3,74436,202950,128514
SMI007-K04-B01-M02,0,2,Pf3D7_13_v3,390734,535986,145252
SMI007-K04-B01-M02,0,2,Pf3D7_13_v3,541246,621831,80585
SMI007-K04-B01-M02,0,2,Pf3D7_13_v3,2537577,2648084,110507
SMI007-K04-B01-M02,0,2,Pf3D7_14_v3,272898,429686,156788
SMI007-K04-B01-M02,0,2,Pf3D7_14_v3,443315,665191,221876
SMI007-K04-B01-M02,0,2,Pf3D7_14_v3,724841,1816976,1092135
SMI007-K04-B01-M02,0,2,Pf3D7_14_v3,2966924,3216241,249317
SMI007-K04-B01-M02,0,3,Pf3D7_01_v3,92914,575569,482655
SMI007-K04-B01-M02,0,3,Pf3D7_02_v3,106095,314816,208721
SMI007-K04-B01-M02,0,3,Pf3D7_02_v3,465275,490738,25463
SMI007-K04-B01-M02,0,3,Pf3D7_02_v3,665889,862487,196598
SMI007-K04-B01-M02,0,3,Pf3D7_03_v3,70645,304034,233389
SMI007-K04-B01-M02,0,3,Pf3D7_03_v3,335293,1002873,667580
SMI007-K04-B01-M02,0,3,Pf3D7_04_v3,91421,100024,8603
SMI007-K04-B01-M02,0,3,Pf3D7_04_v3,1100716,1143943,43227
SMI007-K04-B01-M02,0,3,Pf3D7_05_v3,38009,81966,43957
SMI007-K04-B01-M02,0,3,Pf3D7_05_v3,334078,378369,44291
SMI007-K04-B01-M02,0,3,Pf3D7_05_v3,902412,1233436,331024
SMI007-K04-B01-M02,0,3,Pf3D7_05_v3,1252815,1321344,68529
SMI007-K04-B01-M02,0,3,Pf3D7_06_v3,72403,405955,333552
SMI007-K04-B01-M02,0,3,Pf3D7_06_v3,708357,1294804,586447
SMI007-K04-B01-M02,0,3,Pf3D7_07_v3,77107,80365,3258
SMI007-K04-B01-M02,0,3,Pf3D7_07_v3,452710,475917,23207
SMI007-K04-B01-M02,0,3,Pf3D7_08_v3,107133,638639,531506
SMI007-K04-B01-M02,0,3,Pf3D7_08_v3,848772,1364861,516089
SMI007-K04-B01-M02,0,3,Pf3D7_09_v3,79899,90339,10440
SMI007-K04-B01-M02,0,3,Pf3D7_09_v3,695926,1118520,422594
SMI007-K04-B01-M02,0,3,Pf3D7_10_v3,157307,305179,147872
SMI007-K04-B01-M02,0,3,Pf3D7_10_v3,457074,677437,220363
SMI007-K04-B01-M02,0,3,Pf3D7_10_v3,1128949,1571493,442544
SMI007-K04-B01-M02,0,3,Pf3D7_11_v3,110021,2003304,1893283
SMI007-K04-B01-M02,0,3,Pf3D7_12_v3,60438,511911,451473
SMI007-K04-B01-M02,0,3,Pf3D7_12_v3,627936,820925,192989
SMI007-K04-B01-M02,0,3,Pf3D7_12_v3,869297,1064209,194912
SMI007-K04-B01-M02,0,3,Pf3D7_12_v3,1638465,1670958,32493
SMI007-K04-B01-M02,0,3,Pf3D7_12_v3,1877192,2013870,136678
SMI007-K04-B01-M02,0,3,Pf3D7_13_v3,390734,535986,145252
SMI007-K04-B01-M02,0,3,Pf3D7_13_v3,621831,2159995,1538164
SMI007-K04-B01-M02,0,3,Pf3D7_13_v3,2648084,2791755,143671
SMI007-K04-B01-M02,0,3,Pf3D7_14_v3,35796,443315,407519
SMI007-K04-B01-M02,0,3,Pf3D7_14_v3,665191,724841,59650
SMI007-K04-B01-M02,0,3,Pf3D7_14_v3,912071,1075834,163763
SMI007-K04-B01-M02,0,3,Pf3D7_14_v3,1270940,1723267,452327
SMI007-K04-B01-M02,0,3,Pf3D7_14_v3,1816976,1820417,3441
SMI007-K04-B01-M02,0,3,Pf3D7_14_v3,2966924,3255707,288783
SMI007-K04-B01-M02,1,2,Pf3D7_01_v3,92914,575569,482655
SMI007-K04-B01-M02,1,2,Pf3D7_02_v3,106095,203036,96941
SMI007-K04-B01-M02,1,2,Pf3D7_02_v3,465275,665889,200614
SMI007-K04-B01-M02,1,2,Pf3D7_03_v3,304034,335293,31259
SMI007-K04-B01-M02,1,2,Pf3D7_03_v3,494204,782284,288080
SMI007-K04-B01-M02,1,2,Pf3D7_04_v3,100024,1143943,1043919
SMI007-K04-B01-M02,1,2,Pf3D7_05_v3,38009,378369,340360
SMI007-K04-B01-M02,1,2,Pf3D7_05_v3,1252815,1321344,68529
SMI007-K04-B01-M02,1,2,Pf3D7_06_v3,72403,206654,134251
SMI007-K04-B01-M02,1,2,Pf3D7_06_v3,930617,1183288,252671
SMI007-K04-B01-M02,1,2,Pf3D7_07_v3,80365,202419,122054
SMI007-K04-B01-M02,1,2,Pf3D7_07_v3,234734,1239953,1005219
SMI007-K04-B01-M02,1,2,Pf3D7_08_v3,107133,638639,531506
SMI007-K04-B01-M02,1,2,Pf3D7_08_v3,848772,1364861,516089
SMI007-K04-B01-M02,1,2,Pf3D7_09_v3,79899,90339,10440
SMI007-K04-B01-M02,1,2,Pf3D7_09_v3,695926,1473498,777572
SMI007-K04-B01-M02,1,2,Pf3D7_10_v3,69349,157307,87958
SMI007-K04-B01-M02,1,2,Pf3D7_10_v3,305179,1571493,1266314
SMI007-K04-B01-M02,1,2,Pf3D7_11_v3,110021,453458,343437
SMI007-K04-B01-M02,1,2,Pf3D7_11_v3,835226,1374796,539570
SMI007-K04-B01-M02,1,2,Pf3D7_11_v3,1799850,2003304,203454
SMI007-K04-B01-M02,1,2,Pf3D7_12_v3,60438,112586,52148
SMI007-K04-B01-M02,1,2,Pf3D7_12_v3,177169,256763,79594
SMI007-K04-B01-M02,1,2,Pf3D7_12_v3,358545,440940,82395
SMI007-K04-B01-M02,1,2,Pf3D7_12_v3,820925,1064209,243284
SMI007-K04-B01-M02,1,2,Pf3D7_12_v3,1826163,1877192,51029
SMI007-K04-B01-M02,1,2,Pf3D7_12_v3,1890273,2163685,273412
SMI007-K04-B01-M02,1,2,Pf3D7_13_v3,74436,202950,128514
SMI007-K04-B01-M02,1,2,Pf3D7_13_v3,390734,535986,145252
SMI007-K04-B01-M02,1,2,Pf3D7_13_v3,541246,621831,80585
SMI007-K04-B01-M02,1,2,Pf3D7_13_v3,793453,2159995,1366542
SMI007-K04-B01-M02,1,2,Pf3D7_13_v3,2537577,2573651,36074
SMI007-K04-B01-M02,1,2,Pf3D7_13_v3,2648084,2791755,143671
SMI007-K04-B01-M02,1,2,Pf3D7_14_v3,35796,443315,407519
SMI007-K04-B01-M02,1,2,Pf3D7_14_v3,912071,1075834,163763
SMI007-K04-B01-M02,1,2,Pf3D7_14_v3,1723267,1820417,97150
SMI007-K04-B01-M02,1,2,Pf3D7_14_v3,1825842,2083563,257721
SMI007-K04-B01-M02,1,2,Pf3D7_14_v3,2576461,2835807,259346
SMI007-K04-B01-M02,1,3,Pf3D7_02_v3,490738,588001,97263
SMI007-K04-B01-M02,1,3,Pf3D7_02_v3,665889,822248,156359
SMI007-K04-B01-M02,1,3,Pf3D7_03_v3,335293,1002873,667580
SMI007-K04-B01-M02,1,3,Pf3D7_04_v3,91421,100024,8603
SMI007-K04-B01-M02,1,3,Pf3D7_04_v3,1100716,1143943,43227
SMI007-K04-B01-M02,1,3,Pf3D7_05_v3,38009,334078,296069
SMI007-K04-B01-M02,1,3,Pf3D7_05_v3,902412,1252815,350403
SMI007-K04-B01-M02,1,3,Pf3D7_06_v3,708357,928140,219783
SMI007-K04-B01-M02,1,3,Pf3D7_08_v3,107133,638639,531506
SMI007-K04-B01-M02,1,3,Pf3D7_08_v3,906873,1364861,457988
SMI007-K04-B01-M02,1,3,Pf3D7_09_v3,79899,90339,10440
SMI007-K04-B01-M02,1,3,Pf3D7_09_v3,863928,1473498,609570
SMI007-K04-B01-M02,1,3,Pf3D7_10_v3,69349,157307,87958
SMI007-K04-B01-M02,1,3,Pf3D7_10_v3,305179,1418003,1112824
SMI007-K04-B01-M02,1,3,Pf3D7_11_v3,186888,2003304,1816416
SMI007-K04-B01-M02,1,3,Pf3D7_12_v3,60438,112586,52148
SMI007-K04-B01-M02,1,3,Pf3D7_12_v3,177169,256763,79594
SMI007-K04-B01-M02,1,3,Pf3D7_12_v3,358545,440940,82395
SMI007-K04-B01-M02,1,3,Pf3D7_12_v3,627936,1561003,933067
SMI007-K04-B01-M02,1,3,Pf3D7_13_v3,390734,535986,145252
SMI007-K04-B01-M02,1,3,Pf3D7_13_v3,621831,793453,171622
SMI007-K04-B01-M02,1,3,Pf3D7_13_v3,2573651,2648084,74433
SMI007-K04-B01-M02,1,3,Pf3D7_14_v3,272898,429686,156788
SMI007-K04-B01-M02,1,3,Pf3D7_14_v3,443315,1270940,827625
SMI007-K04-B01-M02,1,3,Pf3D7_14_v3,1825842,2083563,257721
SMI007-K04-B01-M02,1,3,Pf3D7_14_v3,2576461,2835807,259346
SMI007-K04-B01-M02,1,3,Pf3D7_14_v3,3216241,3255707,39466
SMI007-K04-B01-M02,2,3,Pf3D7_02_v3,203036,465275,262239
SMI007-K04-B01-M02,2,3,Pf3D7_02_v3,490738,588001,97263
SMI007-K04-B01-M02,2,3,Pf3D7_02_v3,822248,862487,40239
SMI007-K04-B01-M02,2,3,Pf3D7_03_v3,70645,304034,233389
SMI007-K04-B01-M02,2,3,Pf3D7_03_v3,494204,782284,288080
SMI007-K04-B01-M02,2,3,Pf3D7_04_v3,1100716,1143943,43227
SMI007-K04-B01-M02,2,3,Pf3D7_05_v3,38009,334078,296069
SMI007-K04-B01-M02,2,3,Pf3D7_05_v3,378369,902412,524043
SMI007-K04-B01-M02,2,3,Pf3D7_06_v3,206654,708357,501703
SMI007-K04-B01-M02,2,3,Pf3D7_06_v3,928140,930617,2477
SMI007-K04-B01-M02,2,3,Pf3D7_06_v3,1183288,1294804,111516
SMI007-K04-B01-M02,2,3,Pf3D7_07_v3,77107,80365,3258
SMI007-K04-B01-M02,2,3,Pf3D7_07_v3,202419,234734,32315
SMI007-K04-B01-M02,2,3,Pf3D7_07_v3,1239953,1381532,141579
SMI007-K04-B01-M02,2,3,Pf3D7_08_v3,73645,848772,775127
SMI007-K04-B01-M02,2,3,Pf3D7_08_v3,906873,1364861,457988
SMI007-K04-B01-M02,2,3,Pf3D7_09_v3,79899,695926,616027
SMI007-K04-B01-M02,2,3,Pf3D7_09_v3,863928,1473498,609570
SMI007-K04-B01-M02,2,3,Pf3D7_10_v3,69349,1418003,1348654
SMI007-K04-B01-M02,2,3,Pf3D7_11_v3,186888,453458,266570
SMI007-K04-B01-M02,2,3,Pf3D7_11_v3,835226,1374796,539570
SMI007-K04-B01-M02,2,3,Pf3D7_11_v3,1799850,2003304,203454
SMI007-K04-B01-M02,2,3,Pf3D7_12_v3,60438,627936,567498
SMI007-K04-B01-M02,2,3,Pf3D7_12_v3,820925,1064209,243284
SMI007-K04-B01-M02,2,3,Pf3D7_12_v3,1561003,1826163,265160
SMI007-K04-B01-M02,2,3,Pf3D7_12_v3,1877192,1890273,13081
SMI007-K04-B01-M02,2,3,Pf3D7_13_v3,202950,541246,338296
SMI007-K04-B01-M02,2,3,Pf3D7_13_v3,2159995,2537577,377582
SMI007-K04-B01-M02,2,3,Pf3D7_14_v3,272898,429686,156788
SMI007-K04-B01-M02,2,3,Pf3D7_14_v3,912071,1075834,163763
SMI007-K04-B01-M02,2,3,Pf3D7_14_v3,1270940,1723267,452327
SMI007-K04-B01-M02,2,3,Pf3D7_14_v3,1820417,3216241,1395824
SMI008-K04-B01-M03,0,1,Pf3D7_01_v3,317942,575569,257627
SMI008-K04-B01-M03,0,1,Pf3D7_02_v3,106095,623556,517461
SMI008-K04-B01-M03,0,1,Pf3D7_03_v3,196011,1002873,806862
SMI008-K04-B01-M03,0,1,Pf3D7_04_v3,91421,883597,792176
SMI008-K04-B01-M03,0,1,Pf3D7_04_v3,924164,1001722,77558
SMI008-K04-B01-M03,0,1,Pf3D7_04_v3,1100716,1135687,34971
SMI008-K04-B01-M03,0,1,Pf3D7_04_v3,1142814,1143943,1129
SMI008-K04-B01-M03,0,1,Pf3D7_05_v3,38009,1252815,1214806
SMI008-K04-B01-M03,0,1,Pf3D7_06_v3,114315,649214,534899
SMI008-K04-B01-M03,0,1,Pf3D7_06_v3,930617,1294804,364187
SMI008-K04-B01-M03,0,1,Pf3D7_07_v3,77107,1381532,1304425
SMI008-K04-B01-M03,0,1,Pf3D7_08_v3,73645,247814,174169
SMI008-K04-B01-M03,0,1,Pf3D7_08_v3,317139,1243299,926160
SMI008-K04-B01-M03,0,1,Pf3D7_09_v3,364649,1473498,1108849
SMI008-K04-B01-M03,0,1,Pf3D7_10_v3,69349,305179,235830
SMI008-K04-B01-M03,0,1,Pf3D7_10_v3,596096,632519,36423
SMI008-K04-B01-M03,0,1,Pf3D7_10_v3,897972,1320260,422288
SMI008-K04-B01-M03,0,1,Pf3D7_10_v3,1397838,1571493,173655
SMI008-K04-B01-M03,0,1,Pf3D7_11_v3,110021,133313,23292
SMI008-K04-B01-M03,0,1,Pf3D7_11_v3,453458,1623884,1170426
SMI008-K04-B01-M03,0,1,Pf3D7_12_v3,161768,1302897,1141129
SMI008-K04-B01-M03,0,1,Pf3D7_12_v3,1424116,1613521,189405
SMI008-K04-B01-M03,0,1,Pf3D7_12_v3,1651172,2163685,512513
SMI008-K04-B01-M03,0,1,Pf3D7_13_v3,74436,793453,719017
SMI008-K04-B01-M03,0,1,Pf3D7_13_v3,1537064,1606039,68975
SMI008-K04-B01-M03,0,1,Pf3D7_13_v3,1802676,2791755,989079
SMI008-K04-B01-M03,0,1,Pf3D7_14_v3,35796,1498271,1462475
SMI008-K04-B01-M03,0,1,Pf3D7_14_v3,1526409,2297291,770882
SMI008-K04-B01-M03,0,1,Pf3D7_14_v3,2464746,3255707,790961
SMI008-K04-B01-M03,0,2,Pf3D7_01_v3,341688,540818,199130
SMI008-K04-B01-M03,0,2,Pf3D7_02_v3,431531,684076,252545
SMI008-K04-B01-M03,0,2,Pf3D7_03_v3,196011,1002873,806862
SMI008-K04-B01-M03,0,2,Pf3D7_04_v3,91421,883597,792176
SMI008-K04-B01-M03,0,2,Pf3D7_04_v3,924164,1001722,77558
SMI008-K04-B01-M03,0,2,Pf3D7_04_v3,1142814,1143943,1129
SMI008-K04-B01-M03,0,2,Pf3D7_05_v3,38009,394868,356859
SMI008-K04-B01-M03,0,2,Pf3D7_05_v3,695013,1321344,626331
SMI008-K04-B01-M03,0,2,Pf3D7_06_v3,72403,649214,576811
SMI008-K04-B01-M03,0,2,Pf3D7_06_v3,930617,1294804,364187
SMI008-K04-B01-M03,0,2,Pf3D7_07_v3,77107,1188570,1111463
SMI008-K04-B01-M03,0,2,Pf3D7_07_v3,1214231,1381532,167301
SMI008-K04-B01-M03,0,2,Pf3D7_08_v3,73645,110332,36687
SMI008-K04-B01-M03,0,2,Pf3D7_08_v3,317139,1243299,926160
SMI008-K04-B01-M03,0,2,Pf3D7_09_v3,364649,1473498,1108849
SMI008-K04-B01-M03,0,2,Pf3D7_10_v3,69349,305179,235830
SMI008-K04-B01-M03,0,2,Pf3D7_10_v3,471064,535753,64689
SMI008-K04-B01-M03,0,2,Pf3D7_10_v3,596096,1320260,724164
SMI008-K04-B01-M03,0,2,Pf3D7_10_v3,1394229,1571493,177264
SMI008-K04-B01-M03,0,2,Pf3D7_11_v3,110021,1234479,1124458
SMI008-K04-B01-M03,0,2,Pf3D7_12_v3,161768,1302897,1141129
SMI008-K04-B01-M03,0,2,Pf3D7_12_v3,1424116,1865252,441136
SMI008-K04-B01-M03,0,2,Pf3D7_13_v3,211981,763149,551168
SMI008-K04-B01-M03,0,2,Pf3D7_13_v3,1053788,1953079,899291
SMI008-K04-B01-M03,0,2,Pf3D7_13_v3,2038033,2130771,92738
SMI008-K04-B01-M03,0,2,Pf3D7_13_v3,2193207,2416578,223371
SMI008-K04-B01-M03,0,2,Pf3D7_13_v3,2637864,2648084,10220
SMI008-K04-B01-M03,0,2,Pf3D7_13_v3,2664843,2791755,126912
SMI008-K04-B01-M03,0,2,Pf3D7_14_v3,35796,912071,876275
SMI008-K04-B01-M03,0,2,Pf3D7_14_v3,1006902,1526409,519507
SMI008-K04-B01-M03,0,2,Pf3D7_14_v3,1723267,2297291,574024
SMI008-K04-B01-M03,0,2,Pf3D7_14_v3,2447479,2464746,17267
SMI008-K04-B01-M03,0,2,Pf3D7_14_v3,2782203,2835260,53057
SMI008-K04-B01-M03,0,2,Pf3D7_14_v3,2835807,3255707,419900
SMI008-K04-B01-M03,0,3,Pf3D7_01_v3,92914,317942,225028
SMI008-K04-B01-M03,0,3,Pf3D7_01_v3,341688,540818,199130
SMI008-K04-B01-M03,0,3,Pf3D7_02_v3,431531,623556,192025
SMI008-K04-B01-M03,0,3,Pf3D7_02_v3,684076,862487,178411
SMI008-K04-B01-M03,0,3,Pf3D7_03_v3,70645,1002873,932228
SMI008-K04-B01-M03,0,3,Pf3D7_04_v3,91421,1100716,1009295
SMI008-K04-B01-M03,0,3,Pf3D7_04_v3,1135687,1143943,8256
SMI008-K04-B01-M03,0,3,Pf3D7_05_v3,38009,394868,356859
SMI008-K04-B01-M03,0,3,Pf3D7_05_v3,695013,1252815,557802
SMI008-K04-B01-M03,0,3,Pf3D7_06_v3,114315,1294804,1180489
SMI008-K04-B01-M03,0,3,Pf3D7_07_v3,77107,1188570,1111463
SMI008-K04-B01-M03,0,3,Pf3D7_07_v3,1214231,1381532,167301
SMI008-K04-B01-M03,0,3,Pf3D7_08_v3,73645,110332,36687
SMI008-K04-B01-M03,0,3,Pf3D7_08_v3,247814,1364861,1117047
SMI008-K04-B01-M03,0,3,Pf3D7_09_v3,79899,1473498,1393599
SMI008-K04-B01-M03,0,3,Pf3D7_10_v3,69349,471064,401715
SMI008-K04-B01-M03,0,3,Pf3D7_10_v3,535753,632519,96766
SMI008-K04-B01-M03,0,3,Pf3D7_10_v3,897972,1394229,496257
SMI008-K04-B01-M03,0,3,Pf3D7_10_v3,1397838,1571493,173655
SMI008-K04-B01-M03,0,3,Pf3D7_11_v3,110021,133313,23292
SMI008-K04-B01-M03,0,3,Pf3D7_11_v3,453458,1234479,781021
SMI008-K04-B01-M03,0,3,Pf3D7_11_v3,1623884,2003304,379420
SMI008-K04-B01-M03,0,3,Pf3D7_12_v3,60438,1613521,1553083
SMI008-K04-B01-M03,0,3,Pf3D7_12_v3,1651172,1865252,214080
SMI008-K04-B01-M03,0,3,Pf3D7_13_v3,211981,763149,551168
SMI008-K04-B01-M03,0,3,Pf3D7_13_v3,793453,1053788,260335
SMI008-K04-B01-M03,0,3,Pf3D7_13_v3,1537064,1606039,68975
SMI008-K04-B01-M03,0,3,Pf3D7_13_v3,1802676,1953079,150403
SMI008-K04-B01-M03,0,3,Pf3D7_13_v3,2038033,2130771,92738
SMI008-K04-B01-M03,0,3,Pf3D7_13_v3,2193207,2416578,223371
SMI008-K04-B01-M03,0,3,Pf3D7_13_v3,2637864,2648084,10220
SMI008-K04-B01-M03,0,3,Pf3D7_13_v3,2664843,2791755,126912
SMI008-K04-B01-M03,0,3,Pf3D7_14_v3,35796,912071,876275
SMI008-K04-B01-M03,0,3,Pf3D7_14_v3,1006902,1498271,491369
SMI008-K04-B01-M03,0,3,Pf3D7_14_v3,1723267,2447479,724212
SMI008-K04-B01-M03,0,3,Pf3D7_14_v3,2782203,2835260,53057
SMI008-K04-B01-M03,0,3,Pf3D7_14_v3,2835807,3255707,419900
SMI008-K04-B01-M03,1,2,Pf3D7_01_v3,92914,317942,225028
SMI008-K04-B01-M03,1,2,Pf3D7_01_v3,341688,540818,199130
SMI008-K04-B01-M03,1,2,Pf3D7_02_v3,431531,623556,192025
SMI008-K04-B01-M03,1,2,Pf3D7_02_v3,684076,862487,178411
SMI008-K04-B01-M03,1,2,Pf3D7_03_v3,70645,1002873,932228
SMI008-K04-B01-M03,1,2,Pf3D7_04_v3,91421,1100716,1009295
SMI008-K04-B01-M03,1,2,Pf3D7_04_v3,1135687,1143943,8256
SMI008-K04-B01-M03,1,2,Pf3D7_05_v3,38009,394868,356859
SMI008-K04-B01-M03,1,2,Pf3D7_05_v3,695013,1252815,557802
SMI008-K04-B01-M03,1,2,Pf3D7_06_v3,114315,1294804,1180489
SMI008-K04-B01-M03,1,2,Pf3D7_07_v3,77107,1188570,1111463
SMI008-K04-B01-M03,1,2,Pf3D7_07_v3,1214231,1381532,167301
SMI008-K04-B01-M03,1,2,Pf3D7_08_v3,73645,110332,36687
SMI008-K04-B01-M03,1,2,Pf3D7_08_v3,247814,1364861,1117047
SMI008-K04-B01-M03,1,2,Pf3D7_09_v3,79899,1473498,1393599
SMI008-K04-B01-M03,1,2,Pf3D7_10_v3,69349,471064,401715
SMI008-K04-B01-M03,1,2,Pf3D7_10_v3,535753,632519,96766
SMI008-K04-B01-M03,1,2,Pf3D7_10_v3,897972,1394229,496257
SMI008-K04-B01-M03,1,2,Pf3D7_10_v3,1397838,1571493,173655
SMI008-K04-B01-M03,1,2,Pf3D7_11_v3,110021,133313,23292
SMI008-K04-B01-M03,1,2,Pf3D7_11_v3,453458,1234479,781021
SMI008-K04-B01-M03,1,2,Pf3D7_11_v3,1623884,2003304,379420
SMI008-K04-B01-M03,1,2,Pf3D7_12_v3,60438,1613521,1553083
SMI008-K04-B01-M03,1,2,Pf3D7_12_v3,1651172,1865252,214080
SMI008-K04-B01-M03,1,2,Pf3D7_13_v3,211981,763149,551168
SMI008-K04-B01-M03,1,2,Pf3D7_13_v3,793453,1053788,260335
SMI008-K04-B01-M03,1,2,Pf3D7_13_v3,1537064,1606039,68975
SMI008-K04-B01-M03,1,2,Pf3D7_13_v3,1802676,1953079,150403
SMI008-K04-B01-M03,1,2,Pf3D7_13_v3,2038033,2130771,92738
SMI008-K04-B01-M03,1,2,Pf3D7_13_v3,2193207,2416578,223371
SMI008-K04-B01-M03,1,2,Pf3D7_13_v3,2637864,2648084,10220
SMI008-K04-B01-M03,1,2,Pf3D7_13_v3,2664843,2791755,126912
SMI008-K04-B01-M03,1,2,Pf3D7_14_v3,35796,912071,876275
SMI008-K04-B01-M03,1,2,Pf3D7_14_v3,1006902,1498271,491369
SMI008-K04-B01-M03,1,2,Pf3D7_14_v3,1723267,2447479,724212
SMI008-K04-B01-M03,1,2,Pf3D7_14_v3,2782203,2835260,53057
SMI008-K04-B01-M03,1,2,Pf3D7_14_v3,2835807,3255707,419900
SMI008-K04-B01-M03,1,3,Pf3D7_01_v3,341688,540818,199130
SMI008-K04-B01-M03,1,3,Pf3D7_02_v3,431531,684076,252545
SMI008-K04-B01-M03,1,3,Pf3D7_03_v3,196011,1002873,806862
SMI008-K04-B01-M03,1,3,Pf3D7_04_v3,91421,883597,792176
SMI008-K04-B01-M03,1,3,Pf3D7_04_v3,924164,1001722,77558
SMI008-K04-B01-M03,1,3,Pf3D7_04_v3,1142814,1143943,1129
SMI008-K04-B01-M03,1,3,Pf3D7_05_v3,38009,394868,356859
SMI008-K04-B01-M03,1,3,Pf3D7_05_v3,695013,1321344,626331
SMI008-K04-B01-M03,1,3,Pf3D7_06_v3,72403,649214,576811
SMI008-K04-B01-M03,1,3,Pf3D7_06_v3,930617,1294804,364187
SMI008-K04-B01-M03,1,3,Pf3D7_07_v3,77107,1188570,1111463
SMI008-K04-B01-M03,1,3,Pf3D7_07_v3,1214231,1381532,167301
SMI008-K04-B01-M03,1,3,Pf3D7_08_v3,73645,110332,36687
SMI008-K04-B01-M03,1,3,Pf3D7_08_v3,317139,1243299,926160
SMI008-K04-B01-M03,1,3,Pf3D7_09_v3,364649,1473498,1108849
SMI008-K04-B01-M03,1,3,Pf3D7_10_v3,69349,305179,235830
SMI008-K04-B01-M03,1,3,Pf3D7_10_v3,471064,535753,64689
SMI008-K04-B01-M03,1,3,Pf3D7_10_v3,596096,1320260,724164
SMI008-K04-B01-M03,1,3,Pf3D7_10_v3,1394229,1571493,177264
SMI008-K04-B01-M03,1,3,Pf3D7_11_v3,110021,1234479,1124458
SMI008-K04-B01-M03,1,3,Pf3D7_12_v3,161768,1302897,1141129
SMI008-K04-B01-M03,1,3,Pf3D7_12_v3,1424116,1865252,441136
SMI008-K04-B01-M03,1,3,Pf3D7_13_v3,211981,763149,551168
SMI008-K04-B01-M03,1,3,Pf3D7_13_v3,1053788,1953079,899291
SMI008-K04-B01-M03,1,3,Pf3D7_13_v3,2038033,2130771,92738
SMI008-K04-B01-M03,1,3,Pf3D7_13_v3,2193207,2416578,223371
SMI008-K04-B01-M03,1,3,Pf3D7_13_v3,2637864,2648084,10220
SMI008-K04-B01-M03,1,3,Pf3D7_13_v3,2664843,2791755,126912
SMI008-K04-B01-M03,1,3,Pf3D7_14_v3,35796,912071,876275
SMI008-K04-B01-M03,1,3,Pf3D7_14_v3,1006902,1526409,519507
SMI008-K04-B01-M03,1,3,Pf3D7_14_v3,1723267,2297291,574024
SMI008-K04-B01-M03,1,3,Pf3D7_14_v3,2447479,2464746,17267
SMI008-K04-B01-M03,1,3,Pf3D7_14_v3,2782203,2835260,53057
SMI008-K04-B01-M03,1,3,Pf3D7_14_v3,2835807,3255707,419900
SMI008-K04-B01-M03,2,3,Pf3D7_01_v3,317942,575569,257627
SMI008-K04-B01-M03,2,3,Pf3D7_02_v3,106095,623556,517461
SMI008-K04-B01-M03,2,3,Pf3D7_03_v3,196011,1002873,806862
SMI008-K04-B01-M03,2,3,Pf3D7_04_v3,91421,883597,792176
SMI008-K04-B01-M03,2,3,Pf3D7_04_v3,924164,1001722,77558
SMI008-K04-B01-M03,2,3,Pf3D7_04_v3,1100716,1135687,34971
SMI008-K04-B01-M03,2,3,Pf3D7_04_v3,1142814,1143943,1129
SMI008-K04-B01-M03,2,3,Pf3D7_05_v3,38009,1252815,1214806
SMI008-K04-B01-M03,2,3,Pf3D7_06_v3,114315,649214,534899
SMI008-K04-B01-M03,2,3,Pf3D7_06_v3,930617,1294804,364187
SMI008-K04-B01-M03,2,3,Pf3D7_07_v3,77107,1381532,1304425
SMI008-K04-B01-M03,2,3,Pf3D7_08_v3,73645,247814,174169
SMI008-K04-B01-M03,2,3,Pf3D7_08_v3,317139,1243299,926160
SMI008-K04-B01-M03,2,3,Pf3D7_09_v3,364649,1473498,1108849
SMI008-K04-B01-M03,2,3,Pf3D7_10_v3,69349,305179,235830
SMI008-K04-B01-M03,2,3,Pf3D7_10_v3,596096,632519,36423
SMI008-K04-B01-M03,2,3,Pf3D7_10_v3,897972,1320260,422288
SMI008-K04-B01-M03,2,3,Pf3D7_10_v3,1397838,1571493,173655
SMI008-K04-B01-M03,2,3,Pf3D7_11_v3,110021,133313,23292
SMI008-K04-B01-M03,2,3,Pf3D7_11_v3,453458,1623884,1170426
SMI008-K04-B01-M03,2,3,Pf3D7_12_v3,161768,1302897,1141129
SMI008-K04-B01-M03,2,3,Pf3D7_12_v3,1424116,1613521,189405
SMI008-K04-B01-M03,2,3,Pf3D7_12_v3,1651172,2163685,512513
SMI008-K04-B01-M03,2,3,Pf3D7_13_v3,74436,793453,719017
SMI008-K04-B01-M03,2,3,Pf3D7_13_v3,1537064,1606039,68975
SMI008-K04-B01-M03,2,3,Pf3D7_13_v3,1802676,2791755,989079
SMI008-K04-B01-M03,2,3,Pf3D7_14_v3,35796,1498271,1462475
SMI008-K04-B01-M03,2,3,Pf3D7_14_v3,1526409,2297291,770882
SMI008-K04-B01-M03,2,3,Pf3D7_14_v3,2464746,3255707,790961
SMI009-K04-B02-M02,0,1,Pf3D7_02_v3,490738,588001,97263
SMI009-K04-B02-M02,0,1,Pf3D7_03_v3,365068,1002873,637805
SMI009-K04-B02-M02,0,1,Pf3D7_04_v3,91421,129714,38293
SMI009-K04-B02-M02,0,1,Pf3D7_05_v3,738999,1173131,434132
SMI009-K04-B02-M02,0,1,Pf3D7_07_v3,653049,893290,240241
SMI009-K04-B02-M02,0,1,Pf3D7_08_v3,317139,491808,174669
SMI009-K04-B02-M02,0,1,Pf3D7_08_v3,1170224,1364861,194637
SMI009-K04-B02-M02,0,1,Pf3D7_09_v3,79899,1473498,1393599
SMI009-K04-B02-M02,0,1,Pf3D7_10_v3,69349,84415,15066
SMI009-K04-B02-M02,0,1,Pf3D7_10_v3,1164301,1168451,4150
SMI009-K04-B02-M02,0,1,Pf3D7_11_v3,748559,1658212,909653
SMI009-K04-B02-M02,0,1,Pf3D7_11_v3,1720565,2003304,282739
SMI009-K04-B02-M02,0,1,Pf3D7_12_v3,60438,1561003,1500565
SMI009-K04-B02-M02,0,1,Pf3D7_12_v3,1670888,2163685,492797
SMI009-K04-B02-M02,0,1,Pf3D7_13_v3,74436,256278,181842
SMI009-K04-B02-M02,0,1,Pf3D7_13_v3,867654,877882,10228
SMI009-K04-B02-M02,0,1,Pf3D7_13_v3,1143558,1733487,589929
SMI009-K04-B02-M02,0,1,Pf3D7_13_v3,1854292,2193207,338915
SMI009-K04-B02-M02,0,1,Pf3D7_13_v3,2298757,2362824,64067
SMI009-K04-B02-M02,0,1,Pf3D7_13_v3,2646682,2648084,1402
SMI009-K04-B02-M02,0,1,Pf3D7_13_v3,2686829,2791755,104926
SMI009-K04-B02-M02,0,1,Pf3D7_14_v3,35796,240164,204368
SMI009-K04-B02-M02,0,1,Pf3D7_14_v3,860162,1033182,173020
SMI009-K04-B02-M02,0,1,Pf3D7_14_v3,1288988,1777070,488082
SMI009-K04-B02-M02,0,1,Pf3D7_14_v3,2621496,3255707,634211
SMI009-K04-B02-M02,0,1,Pf3D7_02_v3,304241,862487,558246
SMI009-K04-B02-M02,0,1,Pf3D7_03_v3,70645,196011,125366
SMI009-K04-B02-M02,0,1,Pf3D7_04_v3,112792,813635,700843
SMI009-K04-B02-M02,0,1,Pf3D7_04_v3,880848,1143943,263095
SMI009-K04-B02-M02,0,1,Pf3D7_05_v3,38009,1321344,1283335
SMI009-K04-B02-M02,0,1,Pf3D7_06_v3,72403,823079,750676
SMI009-K04-B02-M02,0,1,Pf3D7_06_v3,930617,1294804,364187
SMI009-K04-B02-M02,0,1,Pf3D7_07_v3,77107,879985,802878
SMI009-K04-B02-M02,0,1,Pf3D7_08_v3,906873,1364861,457988
SMI009-K04-B02-M02,0,1,Pf3D7_09_v3,79899,1093675,1013776
SMI009-K04-B02-M02,0,1,Pf3D7_10_v3,606909,1141242,534333
SMI009-K04-B02-M02,0,1,Pf3D7_10_v3,1550344,1571493,21149
SMI009-K04-B02-M02,0,1,Pf3D7_11_v3,110021,1534897,1424876
SMI009-K04-B02-M02,0,1,Pf3D7_11_v3,1599475,2003304,403829
SMI009-K04-B02-M02,0,1,Pf3D7_12_v3,60438,486212,425774
SMI009-K04-B02-M02,0,1,Pf3D7_12_v3,936454,1367715,431261
SMI009-K04-B02-M02,0,1,Pf3D7_12_v3,1475435,2163685,688250
SMI009-K04-B02-M02,0,1,Pf3D7_13_v3,74436,1858262,1783826
SMI009-K04-B02-M02,0,1,Pf3D7_13_v3,1935428,2292282,356854
SMI009-K04-B02-M02,0,1,Pf3D7_13_v3,2363740,2648084,284344
SMI009-K04-B02-M02,0,1,Pf3D7_13_v3,2649584,2791755,142171
SMI009-K04-B02-M02,0,1,Pf3D7_14_v3,35796,3255707,3219911
